date,融资余额,融资买入额,融资偿还额,融资净买入,融券余额,融券余量,融券卖出量,融券偿还量,融券净卖出,两融总额,两融差额,A股成交额,B股成交额,科创板成交额
20100331,5824813,5866316,,,24142,2900,3100,,,5848955,5800671,122455748342.0,365640067.0,
20100401,6842114,1054024,36723.0,1017301.0,17325,2200,0,700.0,-700.0,6859439,6824789,153569686557.0,515039987.0,
20100402,6762781,207516,286849.0,-79333.0,11929,1500,0,700.0,-700.0,6774710,6750852,150647493391.0,428310741.0,
20100406,10091243,3329461,999.0,3328462.0,10267,1400,0,100.0,-100.0,10101510,10080976,143949466592.0,303713015.0,
20100407,25086826,15141395,145812.0,14995583.0,38418,2800,1400,0.0,1400.0,25125244,25048408,126435507186.0,445020570.0,
20100408,30233781,5147142,187.0,5146955.0,10110,1400,0,1400.0,-1400.0,30243891,30223671,141846605678.0,482259945.0,
20100409,50663640,22077191,1647332.0,20429859.0,10197,1400,0,0.0,0.0,50673837,50653443,133531230992.0,632492800.0,
20100412,89060984,40376602,1979258.0,38397344.0,10092,1400,5000,5000.0,0.0,89071076,89050892,174674556389.0,735135022.0,
20100413,92169145,17444196,14336035.0,3108161.0,211445,5200,3900,100.0,3800.0,92380590,91957700,184201759612.0,574317456.0,
20100414,89480507,7964900,10653538.0,-2688638.0,212231,5100,0,100.0,-100.0,89692738,89268276,137642795958.0,350926556.0,
20100415,103099287,20916787,7298007.0,13618780.0,271214,6200,1100,0.0,1100.0,103370501,102828073,136586821958.0,343457377.0,
20100416,121064474,25841176,7875989.0,17965187.0,1198858,24500,19300,1000.0,18300.0,122263332,119865616,102735974511.0,261784862.0,
20100419,112783831,8395193,16675836.0,-8280643.0,1031561,22000,1500,4000.0,-2500.0,113815392,111752270,155841194427.0,553236920.0,
20100420,116673356,5706716,1817191.0,3889525.0,1638860,33400,525900,514500.0,11400.0,118312216,115034496,124510497516.0,356447127.0,
20100421,127565065,14384413,3492704.0,10891709.0,2513143,110300,97300,20400.0,76900.0,130078208,125051922,145671000371.0,376369222.0,
20100422,157219058,32603174,2949181.0,29653993.0,2932237,135400,192400,167300.0,25100.0,160151295,154286821,153245392710.0,400175363.0,
20100423,152902064,17574818,21891812.0,-4316994.0,2830321,137600,15700,13500.0,2200.0,155732385,150071743,135456999196.0,554800642.0,
20100426,182090321,35141973,5953716.0,29188257.0,11042183,278900,193800,52500.0,141300.0,193132504,171048138,115854866925.0,557019109.0,
20100427,202494937,29621581,9216965.0,20404616.0,2758191,142500,76000,212400.0,-136400.0,205253128,199736746,130690557933.0,609866797.0,
20100428,223249365,31144701,10390273.0,20754428.0,2709735,136600,2100,8000.0,-5900.0,225959100,220539630,104499317462.0,522658899.0,
20100429,233030157,27561491,17780699.0,9780792.0,2847328,137763,12363,11200.0,1163.0,235877485,230182829,111720298117.0,501502973.0,
20100430,235526412,27804556,25308301.0,2496255.0,2551528,130863,20400,27300.0,-6900.0,238077940,232974884,105565783985.0,427733989.0,
20100504,242846863,21944030,14623579.0,7320451.0,3519010,200763,116400,46500.0,69900.0,246365873,239327853,78524823342.0,276541991.0,
20100505,277495916,50597915,15948862.0,34649053.0,5144755,286963,101100,14900.0,86200.0,282640671,272351161,113545790667.0,658129558.0,
20100506,314003383,55666699,19159232.0,36507467.0,3286323,183263,15400,119100.0,-103700.0,317289706,310717060,112785914082.0,458147006.0,
20100507,309938569,48359014,52423828.0,-4064814.0,4275122,204363,59300,38200.0,21100.0,314213691,305663447,108443818016.0,419150628.0,
20100510,327370089,36414703,18983183.0,17431520.0,6273327,310636,181436,75163.0,106273.0,333643416,321096762,95134907113.0,420287804.0,
20100511,350667983,47067392,23769498.0,23297894.0,6053063,302868,144200,151968.0,-7768.0,356721046,344614920,100818270915.0,174185908.0,
20100512,376113669,43090277,17644591.0,25445686.0,6718753,357000,246200,192068.0,54132.0,382832422,369394916,90160810499.0,432687443.0,
20100513,393357604,43516642,26272707.0,17243935.0,8409102,420400,156800,93400.0,63400.0,401766706,384948502,90473537212.0,350629671.0,
20100514,415983876,43883229,21256957.0,22626272.0,6807124,391106,296106,325400.0,-29294.0,422791000,409176752,82335381704.0,308515533.0,
20100517,473201524,74027562,16809914.0,57217648.0,4442929,304500,24200,110806.0,-86606.0,477644453,468758595,87806227185.0,401380088.0,
20100518,467622771,32532723,38111476.0,-5578753.0,5137036,291000,135000,148500.0,-13500.0,472759807,462485735,84304001149.0,406718071.0,
20100519,475810742,28129781,19941810.0,8187971.0,5307357,374900,224067,140167.0,83900.0,481118099,470503385,76521500561.0,208961041.0,
20100520,486806982,32023540,21027300.0,10996240.0,9010047,768093,727990,334797.0,393193.0,495817029,477796935,71738426426.0,289042368.0,
20100521,503728469,51052980,34131493.0,16921487.0,8942658,389690,346500,724903.0,-378403.0,512671127,494785811,86733653594.0,297119530.0,
20100524,534671504,76158631,45215596.0,30943035.0,14057930,1559490,1226200,56400.0,1169800.0,548729434,520613574,121325317884.0,477728304.0,
20100525,562759014,56337279,28249769.0,28087510.0,10017758,485200,146900,1221190.0,-1074290.0,572776772,552741256,101525798027.0,290239535.0,
20100526,565966886,17672866,14464994.0,3207872.0,9060668,474000,48300,59500.0,-11200.0,575027554,556906218,74870962324.0,339141959.0,
20100527,604281887,69689203,31374202.0,38315001.0,5436101,310600,26200,189600.0,-163400.0,609717988,598845786,96278588344.0,291191093.0,
20100528,633696229,56487576,27073234.0,29414342.0,4162822,239300,45000,116300.0,-71300.0,637859051,629533407,98506135587.0,245417842.0,
20100531,629837529,37471239,41329939.0,-3858700.0,10343585,1974600,1810900,75600.0,1735300.0,640181114,619493944,86987670740.0,231495210.0,
20100601,639998626,41486233,31325136.0,10161097.0,12838683,2343493,435931,67038.0,368893.0,652837309,627159943,79611740576.0,267269558.0,
20100602,653397284,27207650,13808992.0,13398658.0,12525827,2342631,44600,45462.0,-862.0,665923111,640871457,69539831185.0,158183926.0,
20100603,675126222,38752924,17023986.0,21728938.0,14194808,2434617,147786,55800.0,91986.0,689321030,660931414,74221255814.0,241178239.0,
20100604,680721701,31729497,26134018.0,5595479.0,14822564,2472131,119400,81886.0,37514.0,695544265,665899137,60421824898.0,286366614.0,
20100607,685693950,28140634,23168385.0,4972249.0,6756505,281931,98200,2288400.0,-2190200.0,692450455,678937445,69962288217.0,258758701.0,
20100608,697311113,34230923,22613760.0,11617163.0,4737840,241031,87500,128400.0,-40900.0,702048953,692573273,69040734593.0,315874179.0,
20100609,785253681,126771313,38828745.0,87942568.0,9413470,409431,281700,113300.0,168400.0,794667151,775840211,102302973742.0,402608530.0,
20100610,793255677,41796850,33794854.0,8001996.0,7456056,347231,105400,167600.0,-62200.0,800711733,785799621,80300915589.0,268373450.0,
20100611,782619926,44972146,55607897.0,-10635751.0,7216554,334618,56218,68831.0,-12613.0,789836480,775403372,73721430882.0,304332818.0,
20100617,802191743,35258695,15686878.0,19571817.0,6931429,334518,41900,42000.0,-100.0,809123172,795260314,61497549856.0,239579951.0,
20100618,819295645,46482526,29378624.0,17103902.0,5861101,298251,63541,99808.0,-36267.0,825156746,813434544,72561535429.0,355595496.0,
20100621,859456754,99484877,59323768.0,40161109.0,9530834,414051,204100,88300.0,115800.0,868987588,849925920,81303110593.0,390917544.0,
20100622,867189284,42295789,34563259.0,7732530.0,10065984,413651,29900,30300.0,-400.0,877255268,857123300,65687989840.0,238384633.0,
20100623,842719148,47607058,72077194.0,-24470136.0,8465580,364651,44600,93600.0,-49000.0,851184728,834253568,61481543458.0,436652695.0,
20100624,866091036,47947796,24575908.0,23371888.0,8977774,346051,55200,73800.0,-18600.0,875068810,857113262,50831697920.0,218585438.0,
20100625,877045659,30535042,19580419.0,10954623.0,9449157,361467,139803,124387.0,15416.0,886494816,867596502,51480042324.0,211130444.0,
20100628,907046989,52375764,22374434.0,30001330.0,8937135,393079,115300,83688.0,31612.0,915984124,898109854,45091347957.0,252566798.0,
20100629,901933545,56320628,61434072.0,-5113444.0,8772089,365444,153911,181546.0,-27635.0,910705634,893161456,71240724427.0,502353519.0,
20100630,908521076,35114468,28526937.0,6587531.0,8247937,327344,149700,187800.0,-38100.0,916769013,900273139,51064003698.0,260019575.0,
20100701,928736463,42612154,22396767.0,20215387.0,9185768,435844,123100,14600.0,108500.0,937922231,919550695,46436928556.0,162824352.0,
20100702,946500624,55619277,37855116.0,17764161.0,9352154,435344,123700,124200.0,-500.0,955852778,937148470,61381454821.0,262430441.0,
20100705,1035344028,118587870,29744466.0,88843404.0,9394483,428744,104096,110696.0,-6600.0,1044738511,1025949545,43082777206.0,131390885.0,
20100706,1057442951,59076920,36977997.0,22098923.0,9638251,444633,116200,100311.0,15889.0,1067081202,1047804700,55371110790.0,269056127.0,
20100707,1064383786,44925331,37984496.0,6940835.0,9798533,466733,116400,94300.0,22100.0,1074182319,1054585253,52492425181.0,232748663.0,
20100708,1102548838,65542507,27377455.0,38165052.0,10084050,493933,126900,99700.0,27200.0,1112632888,1092464788,50381326034.0,182619449.0,
20100709,1170639291,157020933,88930480.0,68090453.0,11009953,561433,141000,73500.0,67500.0,1181649244,1159629338,81739284958.0,328425524.0,
20100712,1222983113,122496033,70152211.0,52343822.0,11397184,583333,51100,29200.0,21900.0,1234380297,1211585929,81279475920.0,301129603.0,
20100713,1311949508,122088757,33122362.0,88966395.0,11843759,632033,92400,43700.0,48700.0,1323793267,1300105749,63395605339.0,245146611.0,
20100714,1263477734,80227880,128699654.0,-48471774.0,12064921,646733,156700,142000.0,14700.0,1275542655,1251412813,70102727657.0,260229978.0,
20100715,1287501800,60785184,36761118.0,24024066.0,11102706,584433,34500,96800.0,-62300.0,1298604506,1276399094,72342485300.0,223409226.0,
20100716,1319305043,47955270,16152027.0,31803243.0,11100827,578433,63100,69100.0,-6000.0,1330405870,1308204216,55893335467.0,183580954.0,
20100719,1303905018,71278412,86678437.0,-15400025.0,11856372,611033,88900,56300.0,32600.0,1315761390,1292048646,79295286585.0,297976541.0,
20100720,1440850708,212954187,76008497.0,136945690.0,12001535,612483,123700,122250.0,1450.0,1452852243,1428849173,111396943848.0,341983901.0,
20100721,1472317314,100091861,68625255.0,31466606.0,10765589,508033,35000,139450.0,-104450.0,1483082903,1461551725,105518724348.0,269752150.0,
20100722,1498641789,89420614,63096139.0,26324475.0,10950510,516133,21800,13700.0,8100.0,1509592299,1487691279,95591665619.0,243258425.0,
20100723,1539431335,149445421,108655875.0,40789546.0,11236586,540743,84000,59390.0,24610.0,1550667921,1528194749,101046720485.0,345913001.0,
20100726,1551684452,71587341,59334224.0,12253117.0,12879111,662543,194500,72700.0,121800.0,1564563563,1538805341,88580910905.0,248249184.0,
20100727,1580807913,79519953,50396492.0,29123461.0,12761026,657933,42300,46910.0,-4610.0,1593568939,1568046887,85043640689.0,197935161.0,
20100728,1583742413,108644824,105710324.0,2934500.0,12138814,585884,110851,182900.0,-72049.0,1595881227,1571603599,121607750591.0,407747074.0,
20100729,1531824312,98484393,150402494.0,-51918101.0,12045927,566584,97800,117100.0,-19300.0,1543870239,1519778385,130992551666.0,316432530.0,
20100730,1552855454,92133368,71102226.0,21031142.0,11038366,501984,27800,92400.0,-64600.0,1563893820,1541817088,93828010841.0,358978344.0,
20100802,1640972044,174443309,86326719.0,88116590.0,10476961,473984,48800,76800.0,-28000.0,1651449005,1630495083,109949011018.0,374458818.0,
20100803,1664552954,129466269,105885359.0,23580910.0,10911462,512284,89600,51300.0,38300.0,1675464416,1653641492,130068941467.0,402271003.0,
20100804,1709199891,126248395,81601458.0,44646937.0,8847500,336784,72900,248400.0,-175500.0,1718047391,1700352391,112491569055.0,420103268.0,
20100805,1775576845,167459563,101082609.0,66376954.0,8153166,287233,22700,72251.0,-49551.0,1783730011,1767423679,115161431766.0,298493786.0,
20100806,1802240599,111988470,85324716.0,26663754.0,8124270,305433,57000,38800.0,18200.0,1810364869,1794116329,122998222262.0,384570472.0,
20100809,1841103737,125992494,87129356.0,38863138.0,9550619,393533,121100,33000.0,88100.0,1850654356,1831553118,126484664981.0,382920803.0,
20100810,1869121672,147571316,119553381.0,28017935.0,8994919,398133,100400,95800.0,4600.0,1878116591,1860126753,129137215191.0,484418501.0,
20100811,1903636176,94087853,59573349.0,34514504.0,8956495,343633,31900,86400.0,-54500.0,1912592671,1894679681,88741880956.0,311776010.0,
20100812,1917657100,97853482,83832558.0,14020924.0,9417267,389033,111600,66200.0,45400.0,1927074367,1908239833,95671116591.0,377747963.0,
20100813,1946004866,104210434,75862668.0,28347766.0,9002846,346333,52900,95600.0,-42700.0,1955007712,1937002020,91044666313.0,332850578.0,
20100816,2011265809,163870333,98609390.0,65260943.0,9432818,373733,68800,41400.0,27400.0,2020698627,2001832991,130516584744.0,419430023.0,
20100817,2052174441,137843946,96935314.0,40908632.0,8541510,309233,43700,108200.0,-64500.0,2060715951,2043632931,128419367794.0,363847264.0,
20100818,2085438731,136209711,102945421.0,33264290.0,9108477,335533,162900,136600.0,26300.0,2094547208,2076330254,128611038649.0,429211410.0,
20100819,2111575425,204734599,178597905.0,26136694.0,10610725,386833,133500,82200.0,51300.0,2122186150,2100964700,133328421051.0,353694734.0,
20100820,2116441794,140901472,136035103.0,4866369.0,7995830,267833,81260,200260.0,-119000.0,2124437624,2108445964,119613226778.0,340659404.0,
20100823,2141737847,113225964,87929911.0,25296053.0,8364909,341633,116500,42700.0,73800.0,2150102756,2133372938,91137956866.0,372551033.0,
20100824,2213911577,143827323,71653593.0,72173730.0,9111951,383389,105200,63444.0,41756.0,2223023528,2204799626,105110898947.0,1244338896.0,
20100825,2190791657,98774816,121894736.0,-23119920.0,9046741,458789,169156,93756.0,75400.0,2199838398,2181744916,106926140188.0,1339601979.0,
20100826,2194536639,76108498,72363516.0,3744982.0,9607119,572045,155600,42344.0,113256.0,2204143758,2184929520,81255988318.0,574098037.0,
20100827,2220473978,88446491,62509152.0,25937339.0,9352048,523445,23800,72400.0,-48600.0,2229826026,2211121930,74811979736.0,417196058.0,
20100830,2285460219,177968857,112982616.0,64986241.0,8624182,305845,71300,288900.0,-217600.0,2294084401,2276836037,120912908467.0,584591671.0,
20100831,2307041382,154108208,132527045.0,21581163.0,10113191,521045,255200,40000.0,215200.0,2317154573,2296928191,124096219108.0,657524680.0,
20100901,2322415396,165106740,149732726.0,15374014.0,8972215,469945,110300,161400.0,-51100.0,2331387611,2313443181,137625493670.0,896626930.0,
20100902,2367547449,198711616,153579563.0,45132053.0,7587947,425345,95300,139900.0,-44600.0,2375135396,2359959502,141513113457.0,560830121.0,
20100903,2347176762,143306467,163677154.0,-20370687.0,6786496,436544,55200,44001.0,11199.0,2353963258,2340390266,145530364732.0,658958997.0,
20100906,2387662569,184925685,144439878.0,40485807.0,9436998,468544,80100,48100.0,32000.0,2397099567,2378225571,159875908560.0,409264284.0,
20100907,2414136562,134071867,107597874.0,26473993.0,8658064,489245,115100,94399.0,20701.0,2422794626,2405478498,123327647103.0,406507532.0,
20100908,2493160533,213749417,134725446.0,79023971.0,6860345,349545,60900,200600.0,-139700.0,2500020878,2486300188,130714394517.0,419761175.0,
20100909,2568993058,228372953,152540428.0,75832525.0,5937879,228045,63600,185100.0,-121500.0,2574930937,2563055179,155720479174.0,481204380.0,
20100910,2568640986,103135866,103487938.0,-352072.0,6690296,278145,96100,46000.0,50100.0,2575331282,2561950690,133655246464.0,537524177.0,
20100913,2621304462,192569363,139905887.0,52663476.0,6631071,257645,9700,30200.0,-20500.0,2627935533,2614673391,140414639534.0,476888848.0,
20100914,2618194471,122089778,125199769.0,-3109991.0,5944824,201445,32200,88400.0,-56200.0,2624139295,2612249647,140889265280.0,401282612.0,
20100915,2614204191,128825123,132815403.0,-3990280.0,5674825,196745,17600,22300.0,-4700.0,2619879016,2608529366,138206175249.0,450119439.0,
20100916,2631809132,129223608,111618667.0,17604941.0,5954733,204045,33100,25800.0,7300.0,2637763865,2625854399,128069828922.0,505722383.0,
20100917,2668066420,117420810,81163522.0,36257288.0,5944573,206545,30600,28100.0,2500.0,2674010993,2662121847,94517813776.0,341945638.0,
20100920,2736068769,127859806,59857457.0,68002349.0,6277730,233945,48100,20700.0,27400.0,2742346499,2729791039,89608967018.0,261524331.0,
20100921,2724501690,73780692,85347771.0,-11567079.0,6292451,233745,15500,15700.0,-200.0,2730794141,2718209239,66115160710.0,242888445.0,
20100927,2778508977,162672915,108665628.0,54007287.0,5760387,214245,4500,24000.0,-19500.0,2784269364,2772748590,90171493375.0,368919459.0,
20100928,2795750305,142460313,125218985.0,17241328.0,5524300,206845,1200,8600.0,-7400.0,2801274605,2790226005,115218291400.0,301610294.0,
20100929,2821582317,163401189,137569177.0,25832012.0,4995213,182345,26200,50700.0,-24500.0,2826577530,2816587104,106827024977.0,320869321.0,
20100930,2846908595,230489640,205163362.0,25326278.0,5757722,187545,50300,45100.0,5200.0,2852666317,2841150873,106893897099.0,390705042.0,
20101008,2879844623,352236845,319300817.0,32936028.0,8043235,251233,116900,53212.0,63688.0,2887887858,2871801388,166943475641.0,858338635.0,
20101011,2854342169,540431173,565933627.0,-25502454.0,11346296,397333,234200,88100.0,146100.0,2865688465,2842995873,253283807839.0,948244692.0,
20101012,2911633870,466185821,408894120.0,57291701.0,12313951,465533,123100,54900.0,68200.0,2923947821,2899319919,211264209043.0,630871894.0,
20101013,2945491873,511670532,477812529.0,33858003.0,15999257,739533,387000,113000.0,274000.0,2961491130,2929492616,227904183984.0,616177886.0,
20101014,3012610812,643408502,576289563.0,67118939.0,22358972,1183133,645300,201700.0,443600.0,3034969784,2990251840,264411065281.0,711186069.0,
20101015,3074262298,763331295,701679809.0,61651486.0,20101316,1124694,669000,727439.0,-58439.0,3094363614,3054160982,272300573593.0,661644968.0,
20101018,3152329327,777043254,698976225.0,78067029.0,17962007,940407,285274,469561.0,-184287.0,3170291334,3134367320,300511346321.0,795910199.0,
20101019,3288583583,556393938,420139682.0,136254256.0,19002447,928137,203621,215891.0,-12270.0,3307586030,3269581136,199571580430.0,531785771.0,
20101020,3449163925,748459214,587878872.0,160580342.0,21142887,933337,194000,188800.0,5200.0,3470306812,3428021038,261727851974.0,780324424.0,
20101021,3596853448,449387902,301698379.0,147689523.0,18477168,677432,91500,347405.0,-255905.0,3615330616,3578376280,204662068395.0,523465267.0,
20101022,3755121466,479643761,321375743.0,158268018.0,15181865,475332,41300,243400.0,-202100.0,3770303331,3739939601,194315517019.0,656170141.0,
20101025,3936580107,738284867,556826226.0,181458641.0,15947408,486332,88900,77900.0,11000.0,3952527515,3920632699,251284270920.0,764100485.0,
20101026,4071030302,659869062,525418867.0,134450195.0,16896360,642432,311600,155500.0,156100.0,4087926662,4054133942,259768366638.0,713164711.0,
20101027,4269896802,614699304,415832804.0,198866500.0,13273825,563562,427230,506100.0,-78870.0,4283170627,4256622977,230208345506.0,593114529.0,
20101028,4324880974,447080074,392095902.0,54984172.0,11504878,558536,307300,312326.0,-5026.0,4336385852,4313376096,185954562859.0,510477263.0,
20101029,4296990516,459821357,487711815.0,-27890458.0,8471305,399600,245900,404836.0,-158936.0,4305461821,4288519211,194277814801.0,444215302.0,
20101101,4341749551,498627782,453868747.0,44759035.0,10079811,491400,200210,108410.0,91800.0,4351829362,4331669740,251061669886.0,888878772.0,
20101102,4470409233,771255747,642596065.0,128659682.0,8514685,393200,498653,596853.0,-98200.0,4478923918,4461894548,306710783610.0,981504513.0,
20101103,4579337355,644200987,535272865.0,108928122.0,10323308,540018,328300,181482.0,146818.0,4589660663,4569014047,243986662358.0,664438781.0,
20101104,4687431943,616399880,508305292.0,108094588.0,11538012,608489,370710,302239.0,68471.0,4698969955,4675893931,228491519921.0,763772814.0,
20101105,4878634897,845292430,654089476.0,191202954.0,12221523,610189,147200,145500.0,1700.0,4890856420,4866413374,272792529909.0,996186528.0,
20101108,5205338554,747835334,421131677.0,326703657.0,12687718,690318,321475,241346.0,80129.0,5218026272,5192650836,258251717824.0,1150737357.0,
20101109,5427122250,673362671,451578975.0,221783696.0,8898349,496500,238736,432554.0,-193818.0,5436020599,5418223901,247530726961.0,987859491.0,
20101110,5669380056,742219805,499961999.0,242257806.0,9812493,376923,146123,265700.0,-119577.0,5679192549,5659567563,249145430433.0,837677674.0,
20101111,5772737492,808783051,705425615.0,103357436.0,8561789,393223,225200,208900.0,16300.0,5781299281,5764175703,287326233178.0,929490835.0,
20101112,5535208139,697482878,935012231.0,-237529353.0,6708001,422600,586997,557620.0,29377.0,5541916140,5528500138,297121408357.0,1647273270.0,
20101115,5777852641,640509031,397864529.0,242644502.0,5068891,346400,191576,267776.0,-76200.0,5782921532,5772783750,197764536427.0,971123829.0,
20101116,5759550131,502106601,520409111.0,-18302510.0,2722873,188608,279700,437492.0,-157792.0,5762273004,5756827258,220676150940.0,1087176925.0,
20101117,5816759463,492329349,435120017.0,57209332.0,4704616,340200,387448,235856.0,151592.0,5821464079,5812054847,157947694159.0,827917099.0,
20101118,5825398138,358203003,349564328.0,8638675.0,3358346,272732,254548,322016.0,-67468.0,5828756484,5822039792,127254395575.0,564840823.0,
20101119,5603612499,307385398,529171037.0,-221785639.0,5957617,453648,358538,177622.0,180916.0,5609570116,5597654882,155119572249.0,670404348.0,
20101122,5719559877,469767361,353819983.0,115947378.0,4784637,372748,80200,161100.0,-80900.0,5724344514,5714775240,162086688128.0,696006607.0,
20101123,5739500620,287201446,267260703.0,19940743.0,7526229,514748,229000,87000.0,142000.0,5747026849,5731974391,144676513791.0,741517709.0,
20101124,5822662043,435812235,352650812.0,83161423.0,5899263,417648,97800,194900.0,-97100.0,5828561306,5816762780,149270576996.0,734110143.0,
20101125,5970633357,554239093,406267779.0,147971314.0,8944840,533304,191600,75944.0,115656.0,5979578197,5961688517,166944598293.0,704024778.0,
20101126,5903402929,329668655,396899083.0,-67230428.0,7255734,514357,440380,459327.0,-18947.0,5910658663,5896147195,143227897811.0,534566239.0,
20101129,5929259556,293264104,267407477.0,25856627.0,12689598,1809826,1604077,308608.0,1295469.0,5941949154,5916569958,133498961034.0,578696493.0,
20101130,5936566231,372617460,365310785.0,7306675.0,13391922,1820641,757715,746900.0,10815.0,5949958153,5923174309,172405784309.0,961706290.0,
20101201,5937744337,263690928,262512822.0,1178106.0,13522674,1900828,544289,464102.0,80187.0,5951267011,5924221663,104112950969.0,410139238.0,
20101202,5997821790,308030176,247952723.0,60077453.0,14683623,1913976,517948,504800.0,13148.0,6012505413,5983138167,131801429337.0,442558770.0,
20101203,6090572316,329387031,236636505.0,92750526.0,13480634,1749408,317400,481968.0,-164568.0,6104052950,6077091682,105751051152.0,364454670.0,
20101206,6164097438,382055879,308530757.0,73525122.0,7827321,464227,430100,1715281.0,-1285181.0,6171924759,6156270117,110744846355.0,362528976.0,
20101207,6265658521,452005783,350444700.0,101561083.0,6328242,391987,708000,780240.0,-72240.0,6271986763,6259330279,111009237848.0,386511201.0,
20101208,6287597522,397789735,375850734.0,21939001.0,4904499,394437,452850,450400.0,2450.0,6292502021,6282693023,110334953598.0,353083177.0,
20101209,6527614801,590322354,350305075.0,240017279.0,6716150,621644,648581,421374.0,227207.0,6534330951,6520898651,109362076242.0,269604962.0,
20101210,6644591506,385958637,268981932.0,116976705.0,5320758,409938,604287,815993.0,-211706.0,6649912264,6639270748,98297690464.0,282494917.0,
20101213,7209404871,1038828767,474015402.0,564813365.0,11021133,841438,1088500,657000.0,431500.0,7220426004,7198383738,159937266073.0,546911272.0,
20101214,7373777616,598845377,434472632.0,164372745.0,12452885,1274597,1185359,752200.0,433159.0,7386230501,7361324731,152471834973.0,570922072.0,
20101215,7462794030,542387127,453370713.0,89016414.0,7096652,539843,646067,1380821.0,-734754.0,7469890682,7455697378,143546478769.0,561902516.0,
20101216,7542711921,448723342,368805451.0,79917891.0,6987252,506199,621900,655544.0,-33644.0,7549699173,7535724669,109494268106.0,411609551.0,
20101217,7493201511,245814175,295324585.0,-49510410.0,3888480,307505,436200,634894.0,-198694.0,7497089991,7489313031,93580298653.0,312954979.0,
20101220,7435701311,396781734,454281934.0,-57500200.0,9139721,872930,1300196,734771.0,565425.0,7444841032,7426561590,146274725075.0,606468770.0,
20101221,7564667757,622556317,493589871.0,128966446.0,7898275,550844,757944,1080030.0,-322086.0,7572566032,7556769482,136112023845.0,467913417.0,
20101222,7776178311,569147197,357636643.0,211510554.0,4995923,384706,627562,793700.0,-166138.0,7781174234,7771182388,125945740065.0,327787700.0,
20101223,7817500749,375027731,333705293.0,41322438.0,8295867,659106,725400,451000.0,274400.0,7825796616,7809204882,109354015558.0,387433999.0,
20101224,7897318010,392595142,312777881.0,79817261.0,5257608,432130,430600,657576.0,-226976.0,7902575618,7892060402,95560753915.0,427493856.0,
20101227,7980334051,568941962,485925921.0,83016041.0,7669058,642745,1192141,981526.0,210615.0,7988003109,7972664993,123327615762.0,463806027.0,
20101228,8010109091,405320013,375544973.0,29775040.0,5729010,269648,674382,1047479.0,-373097.0,8015838101,8004380081,96873536940.0,408837747.0,
20101229,8146359995,351203051,214952147.0,136250904.0,5575964,271488,353640,351800.0,1840.0,8151935959,8140784031,76019735548.0,288103077.0,
20101230,8220105721,373192568,299446842.0,73745726.0,6870974,370068,913880,815300.0,98580.0,8226976695,8213234747,86610063502.0,205492854.0,
20101231,8427486678,601063229,393682272.0,207380957.0,4103136,196184,364366,538250.0,-173884.0,8431589814,8423383542,108472465078.0,434134822.0,
20110104,8516136811,727620536,638970403.0,88650133.0,6276423,437889,564533,322828.0,241705.0,8522413234,8509860388,146251712030.0,435830459.0,
20110105,8596471915,631058464,550723360.0,80335104.0,3737827,292089,274600,420400.0,-145800.0,8600209742,8592734088,135302489931.0,401311542.0,
20110106,8727223150,509404270,378653035.0,130751235.0,4413921,326823,377620,342886.0,34734.0,8731637071,8722809229,112902777971.0,577992385.0,
20110107,8690038014,626845747,664030883.0,-37185136.0,9286568,690326,1202003,838500.0,363503.0,8699324582,8680751446,136896701443.0,480822708.0,
20110110,8758781466,560718946,491975494.0,68743452.0,6997014,550461,546062,685927.0,-139865.0,8765778480,8751784452,110645167708.0,366818657.0,
20110111,8667104852,355611110,447287724.0,-91676614.0,10944904,897535,708474,361400.0,347074.0,8678049756,8656159948,94128994580.0,393314387.0,
20110112,8710801634,401466452,357769670.0,43696782.0,10147082,854548,571040,614027.0,-42987.0,8720948716,8700654552,87788460949.0,489528310.0,
20110113,8754029313,367484313,324256634.0,43227679.0,11325427,781358,249101,322291.0,-73190.0,8765354740,8742703886,87747495451.0,333215953.0,
20110114,8769493796,379638726,364174243.0,15464483.0,6913532,702858,423910,502410.0,-78500.0,8776407328,8762580264,90491720620.0,324789708.0,
20110117,8821400941,443218144,391310999.0,51907145.0,7448751,809973,840392,733277.0,107115.0,8828849692,8813952190,104314495519.0,558153612.0,
20110118,8981757570,405004924,244648295.0,160356629.0,5909762,588226,515500,737247.0,-221747.0,8987667332,8975847808,67368732344.0,411328116.0,
20110119,9087977825,462920729,356700474.0,106220255.0,7280845,555611,532300,564915.0,-32615.0,9095258670,9080696980,89588496999.0,397605767.0,
20110120,9086647897,497827964,499157892.0,-1329928.0,6614513,456911,591600,690300.0,-98700.0,9093262410,9080033384,95476372154.0,377202603.0,
20110121,9102872273,540497532,524273156.0,16224376.0,7299859,554580,1357900,1260231.0,97669.0,9110172132,9095572414,102546187253.0,382986227.0,
20110124,9177837418,509692127,434726982.0,74965145.0,9228124,896102,1250571,909049.0,341522.0,9187065542,9168609294,95886856397.0,404269325.0,
20110125,9220062356,346162375,303937437.0,42224938.0,9333398,689771,361280,567611.0,-206331.0,9229395754,9210728958,75394179915.0,295842966.0,
20110126,9349795135,389519420,259786641.0,129732779.0,9365923,808236,544400,425935.0,118465.0,9359161058,9340429212,67140230345.0,227092660.0,
20110127,9429095585,695694010,616393560.0,79300450.0,12945773,1315956,1377700,869980.0,507720.0,9442041358,9416149812,114930350951.0,384932329.0,
20110128,9469502833,447644390,407237142.0,40407248.0,12840273,1277756,515000,553200.0,-38200.0,9482343106,9456662560,98303642273.0,276169445.0,
20110131,9583910868,632364871,517956836.0,114408035.0,15715553,1528405,989600,738951.0,250649.0,9599626421,9568195315,106661342785.0,293266127.0,
20110201,9402454012,392394929,573851785.0,-181456856.0,12960401,961205,673100,1240300.0,-567200.0,9415414413,9389493611,89856042935.0,265988336.0,
20110209,9589509907,529461387,342405492.0,187055895.0,12714493,999913,858828,820120.0,38708.0,9602224400,9576795414,104446745744.0,398118270.0,
20110210,9740914093,491495815,340091629.0,151404186.0,13778369,1092573,430809,338149.0,92660.0,9754692462,9727135724,117124694532.0,453824994.0,
20110211,9771176484,512505121,482242730.0,30262391.0,10218163,863773,183570,412370.0,-228800.0,9781394647,9760958321,127813677060.0,422473730.0,
20110214,9715701377,915382728,970857835.0,-55475107.0,17152769,1398773,895000,360000.0,535000.0,9732854146,9698548608,179774864173.0,508421230.0,
20110215,9596234682,860216663,979683358.0,-119466695.0,14779112,1274273,730800,855300.0,-124500.0,9611013794,9581455570,187167446771.0,529503904.0,
20110216,9792654830,847457177,651037029.0,196420148.0,13686326,1199053,377000,452220.0,-75220.0,9806341156,9778968504,159703653023.0,442419286.0,
20110217,10032421759,955054160,715287231.0,239766929.0,12102813,1174063,586242,611232.0,-24990.0,10044524572,10020318946,168715974751.0,443241465.0,
20110218,10157728964,647287468,521980263.0,125307205.0,11894180,1139340,517100,551823.0,-34723.0,10169623144,10145834784,141864991411.0,372790818.0,
20110221,10315577822,767670898,609822040.0,157848858.0,11621281,1020144,647958,767154.0,-119196.0,10327199103,10303956541,145898403371.0,596842956.0,
20110222,10525272993,1001895274,792200103.0,209695171.0,15915330,1431301,1988907,1577750.0,411157.0,10541188323,10509357663,191077160186.0,722041326.0,
20110223,10619583455,647426365,553115903.0,94310462.0,14897624,972043,1245891,1705149.0,-459258.0,10634481079,10604685831,137223504792.0,516078853.0,
20110224,10796619793,794570977,617534639.0,177036338.0,17262748,1308597,1806055,1469501.0,336554.0,10813882541,10779357045,136846107630.0,569312814.0,
20110225,10858082464,692267202,630804531.0,61462671.0,16338957,932791,1283484,1659290.0,-375806.0,10874421421,10841743507,124066829277.0,600909903.0,
20110228,10886936320,675667868,646814012.0,28853856.0,17100603,1156621,1615160,1391330.0,223830.0,10904036923,10869835717,147740311592.0,617888131.0,
20110301,10924143093,769595277,732388504.0,37206773.0,22389292,1498840,1456341,1114122.0,342219.0,10946532385,10901753801,172288927699.0,526353472.0,
20110302,11009415972,808798087,723525208.0,85272879.0,23705832,1761509,1752220,1489551.0,262669.0,11033121804,10985710140,165080361979.0,434856668.0,
20110303,11046130055,1019788440,983074357.0,36714083.0,57169330,4413327,4624908,1973090.0,2651818.0,11103299385,10988960725,177350084675.0,545164695.0,
20110304,11147027377,747928982,647031660.0,100897322.0,45941862,3154893,2749980,4008414.0,-1258434.0,11192969239,11101085515,144053210341.0,568608314.0,
20110307,11378560775,1337038695,1105505297.0,231533398.0,77652784,4776797,3075421,1453517.0,1621904.0,11456213559,11300907991,207472168574.0,620980269.0,
20110308,11521780981,904709041,761488835.0,143220206.0,71401857,4265229,1756246,2267814.0,-511568.0,11593182838,11450379124,168252071583.0,505652525.0,
20110309,11615540852,801429978,707670107.0,93759871.0,75334080,4563041,2824714,2526902.0,297812.0,11690874932,11540206772,165011468948.0,510964968.0,
20110310,11749387072,849626386,715780166.0,133846220.0,55875733,3864903,1989364,2687502.0,-698138.0,11805262805,11693511339,166201073909.0,416809997.0,
20110311,11973484849,745190335,521092558.0,224097777.0,41932876,3072279,1026502,1819126.0,-792624.0,12015417725,11931551973,152382872988.0,462821433.0,
20110314,12144451877,557513061,386546033.0,170967028.0,35723632,2278770,462300,1255809.0,-793509.0,12180175509,12108728245,152233904928.0,470933459.0,
20110315,12234504116,911628602,821576363.0,90052239.0,53807370,3187169,2658107,1749708.0,908399.0,12288311486,12180696746,187282480580.0,781672283.0,
20110316,12214737047,892411036,912178105.0,-19767069.0,60619177,4176678,2859423,1869914.0,989509.0,12275356224,12154117870,165758033908.0,453829118.0,
20110317,12128220239,761298186,847814994.0,-86516808.0,55122334,3190921,2079084,3064841.0,-985757.0,12183342573,12073097905,170124515002.0,586092197.0,
20110318,12177302266,573637847,524555820.0,49082027.0,52352121,2822995,644890,1012816.0,-367926.0,12229654387,12124950145,127512199872.0,367803493.0,
20110321,12286615929,663574647,554260984.0,109313663.0,53508592,3119346,1095180,798829.0,296351.0,12340124521,12233107337,122241449856.0,323425710.0,
20110322,12389914708,611897421,508598642.0,103298779.0,66353212,4029430,2623142,1713058.0,910084.0,12456267920,12323561496,119909182340.0,316080437.0,
20110323,12473138104,784408790,701185394.0,83223396.0,62197982,3867230,1280206,1442406.0,-162200.0,12535336086,12410940122,138665822033.0,337316538.0,
20110324,12569889147,652630190,555879147.0,96751043.0,68362920,3981062,1179932,1066100.0,113832.0,12638252067,12501526227,137103854345.0,387050877.0,
20110325,12645793482,872828184,796923849.0,75904335.0,58416102,3599329,2152467,2534200.0,-381733.0,12704209584,12587377380,170523342466.0,687969205.0,
20110328,12747132404,1099208957,997870035.0,101338922.0,49224109,3649954,2724000,2673375.0,50625.0,12796356513,12697908295,195824339097.0,595313447.0,
20110329,13000571572,1392433791,1138994623.0,253439168.0,84735680,7308035,6399488,2741407.0,3658081.0,13085307252,12915835892,199119649664.0,716149103.0,
20110330,13114336973,971615362,857849961.0,113765401.0,68312126,5501314,3531533,5338254.0,-1806721.0,13182649099,13046024847,153385880854.0,372117771.0,
20110331,13389814034,957692779,682215718.0,275477061.0,62935430,5412348,4025546,4114512.0,-88966.0,13452749464,13326878604,134223172798.0,424290322.0,
20110401,13397963410,926784061,918634685.0,8149376.0,63330615,5728654,4045524,3729218.0,316306.0,13461294025,13334632795,125525244613.0,369982248.0,
20110406,13311929130,1453562222,1539596502.0,-86034280.0,116722118,9962181,5630068,1396541.0,4233527.0,13428651248,13195207012,176609276974.0,460050583.0,
20110407,13456816257,1083025717,938138590.0,144887127.0,114503907,9643279,2837584,3156486.0,-318902.0,13571320164,13342312350,152824971087.0,436349424.0,
20110408,13663436042,987464836,780845051.0,206619785.0,90126072,7076922,1459031,4025388.0,-2566357.0,13753562114,13573309970,146800657468.0,395803001.0,
20110411,14042989427,1624611942,1245058557.0,379553385.0,91166318,7216389,2178560,2039093.0,139467.0,14134155745,13951823109,182629306712.0,561533763.0,
20110412,14507155762,1382760835,918594500.0,464166335.0,89657042,8994317,5225243,3447315.0,1777928.0,14596812804,14417498720,165138910924.0,466613436.0,
20110413,14822054819,1279809135,964910078.0,314899057.0,79253489,5703039,1932786,5224064.0,-3291278.0,14901308308,14742801330,147259062522.0,464341065.0,
20110414,14893886634,1055293369,983461554.0,71831815.0,77139044,6117783,2627953,2213209.0,414744.0,14971025678,14816747590,148177219887.0,523870426.0,
20110415,14964312035,907993468,837568067.0,70425401.0,79992980,7011864,4872515,3978434.0,894081.0,15044305015,14884319055,148427811204.0,558724932.0,
20110418,15115565632,1078745597,927492000.0,151253597.0,81851545,7706571,3249509,2554802.0,694707.0,15197417177,15033714087,160190450195.0,663593422.0,
20110419,15113883362,833387870,835070140.0,-1682270.0,71154456,6761054,2117258,3062775.0,-945517.0,15185037818,15042728906,165806849164.0,586585057.0,
20110420,15422476966,974222845,665629241.0,308593604.0,66104465,5668500,3303600,4396154.0,-1092554.0,15488581431,15356372501,143643281655.0,419620685.0,
20110421,15678896887,891476736,635056815.0,256419921.0,74874951,6904789,3852804,2616515.0,1236289.0,15753771838,15604021936,149589798804.0,372374415.0,
20110422,15747595484,793020974,724322377.0,68698597.0,73647335,6733335,2122066,2293520.0,-171454.0,15821242819,15673948149,139787984746.0,368032715.0,
20110425,15674614639,831491973,904472818.0,-72980845.0,88110797,10324778,6829894,3238451.0,3591443.0,15762725436,15586503842,140292714930.0,405204192.0,
20110426,15631632543,607506192,650488288.0,-42982096.0,81107842,9058682,2767526,4033622.0,-1266096.0,15712740385,15550524701,112286002808.0,311394955.0,
20110427,15650190523,700835759,682277779.0,18557980.0,70066258,6616761,2820572,5262493.0,-2441921.0,15720256781,15580124265,114121827847.0,964055983.0,
20110428,15496163903,816293853,970320473.0,-154026620.0,69131777,6300953,3717515,4033323.0,-315808.0,15565295680,15427032126,115130750503.0,1036680398.0,
20110429,15489352748,660353548,667164703.0,-6811155.0,77939727,7108920,5409610,4601643.0,807967.0,15567292475,15411413021,92821012308.0,495389119.0,
20110503,15460738148,576526525,605141125.0,-28614600.0,79822417,8520054,4452343,3041209.0,1411134.0,15540560565,15380915731,107550004203.0,390940041.0,
20110504,15343903210,720446025,837280963.0,-116834938.0,90450206,9876674,6684147,5327527.0,1356620.0,15434353416,15253453004,125147680548.0,380128613.0,
20110505,15244339467,517842819,617406562.0,-99563743.0,74631038,8093045,4013594,5797223.0,-1783629.0,15318970505,15169708429,98711428146.0,238897529.0,
20110506,15121981644,575024359,697382182.0,-122357823.0,79037225,7884402,3168270,3376913.0,-208643.0,15201018869,15042944419,105050431172.0,358350709.0,
20110509,15232374677,655677577,545284544.0,110393033.0,79239553,6954166,3053830,3984066.0,-930236.0,15311614230,15153135124,93786178757.0,296367092.0,
20110510,15395985663,549641025,386030039.0,163610986.0,95339354,8506550,4009762,2457378.0,1552384.0,15491325017,15300646309,98254043037.0,305330724.0,
20110511,15401083312,446166522,441068873.0,5097649.0,84911516,6848453,2034728,3692825.0,-1658097.0,15485994828,15316171796,106896044503.0,360165914.0,
20110512,15577419319,637723841,461387834.0,176336007.0,79021693,7396415,2865176,2317214.0,547962.0,15656441012,15498397626,114120667756.0,303947041.0,
20110513,15708129071,839978633,709268881.0,130709752.0,77440669,5952900,2347153,3790668.0,-1443515.0,15785569740,15630688402,103684173201.0,267363369.0,
20110516,15719819800,429035133,417344404.0,11690729.0,77105086,5888151,1494117,1558866.0,-64749.0,15796924886,15642714714,95637389908.0,224430684.0,
20110517,15929011870,531243729,322051659.0,209192070.0,77901100,6135784,3172339,2924706.0,247633.0,16006912970,15851110770,109644253979.0,307042263.0,
20110518,16108290447,488478494,309199917.0,179278577.0,76216406,5823070,1213983,1526697.0,-312714.0,16184506853,16032074041,90266533391.0,194740649.0,
20110519,16077648730,457940932,488582649.0,-30641717.0,87460100,6641537,2057864,1239397.0,818467.0,16165108830,15990188630,91100757078.0,198121298.0,
20110520,16152695129,388182430,313136031.0,75046399.0,83657525,5823957,1343500,2161080.0,-817580.0,16236352654,16069037604,83907195467.0,183638220.0,
20110523,16098875769,583648042,637467402.0,-53819360.0,71963942,4944670,1974913,2854200.0,-879287.0,16170839711,16026911827,111049724327.0,404538229.0,
20110524,16214417437,435565589,320023921.0,115541668.0,81266047,5842578,2168465,1270557.0,897908.0,16295683484,16133151390,88794081114.0,255977394.0,
20110525,16283881810,452351034,382886661.0,69464373.0,79638143,6097604,2105200,1850174.0,255026.0,16363519953,16204243667,86048344643.0,289354153.0,
20110526,16341680214,355960669,298162265.0,57798404.0,78006622,6033407,2108777,2172974.0,-64197.0,16419686836,16263673592,92987022248.0,264903618.0,
20110527,16191808615,353444434,503316033.0,-149871599.0,72613616,5550782,3297768,3780393.0,-482625.0,16264422231,16119194999,91675140507.0,318461883.0,
20110530,16213113108,405172307,383867814.0,21304493.0,81285713,6559796,2173872,1164858.0,1009014.0,16294398821,16131827395,70972363326.0,216839510.0,
20110531,16438326942,605991887,380778053.0,225213834.0,82236507,6405088,2723857,2878565.0,-154708.0,16520563449,16356090435,77771321584.0,339116784.0,
20110601,16497676967,429816133,370466108.0,59350025.0,86503868,5753115,1261193,1913166.0,-651973.0,16584180835,16411173099,77424815692.0,228288196.0,
20110602,16686353331,707660792,518984428.0,188676364.0,71607044,4478362,2568570,3843323.0,-1274753.0,16757960375,16614746287,94110143808.0,245570607.0,
20110603,16651911918,429223785,463665198.0,-34441413.0,69985984,4572371,1436302,1342293.0,94009.0,16721897902,16581925934,78264385533.0,168803209.0,
20110607,16632529204,494847936,514230650.0,-19382714.0,71988989,4933489,1125846,764728.0,361118.0,16704518193,16560540215,79025803358.0,188117126.0,
20110608,16637485175,652215529,647259558.0,4955971.0,82207141,5936404,2297381,1294466.0,1002915.0,16719692316,16555278034,87287395439.0,288367585.0,
20110609,16652969254,536559008,521074929.0,15484079.0,77298236,5502362,1354205,1788247.0,-434042.0,16730267490,16575671018,95063405527.0,592983935.0,
20110610,16706872250,510782266,456879270.0,53902996.0,87414402,6829387,3503615,2176590.0,1327025.0,16794286652,16619457848,82774950598.0,716398450.0,
20110613,16526574094,461222722,641520878.0,-180298156.0,89785589,7313918,2794483,2309952.0,484531.0,16616359683,16436788505,72918921672.0,343036514.0,
20110614,16495870887,632876203,663579410.0,-30703207.0,96724997,7462570,4647154,4498502.0,148652.0,16592595884,16399145890,95017475801.0,350592613.0,
20110615,16604120197,681522651,573273341.0,108249310.0,92799285,7176378,2954550,3240742.0,-286192.0,16696919482,16511320912,85428768647.0,236974810.0,
20110616,16725857941,548958255,427220511.0,121737744.0,80625517,6380948,3149921,3945351.0,-795430.0,16806483458,16645232424,76464824694.0,203426565.0,
20110617,15996336369,543788365,1273309937.0,-729521572.0,85261149,6893626,3206708,2694030.0,512678.0,16081597518,15911075220,74183740757.0,264577848.0,
20110620,16237528175,684553790,443361984.0,241191806.0,84482812,7041289,4208224,4060561.0,147663.0,16322010987,16153045363,65071120244.0,237849440.0,
20110621,16298026991,556172998,495674182.0,60498816.0,108578882,8746775,4500981,2795495.0,1705486.0,16406605873,16189448109,73169141742.0,263593152.0,
20110622,16340605968,458576650,415997673.0,42578977.0,110372758,8562699,3246944,3431020.0,-184076.0,16450978726,16230233210,64470622152.0,289278546.0,
20110623,16344099381,590474443,586981030.0,3493413.0,127163624,10385270,5572437,3749866.0,1822571.0,16471263005,16216935757,82208349025.0,319327046.0,
20110624,16292288301,1246001461,1297812541.0,-51811080.0,139250514,12614137,7404590,5175723.0,2228867.0,16431538815,16153037787,142361535714.0,428924543.0,
20110627,16488029126,875088965,679348140.0,195740825.0,136963765,11729864,3819564,4703837.0,-884273.0,16624992891,16351065361,116090945732.0,261389449.0,
20110628,16606989920,808099694,689138900.0,118960794.0,140407937,12446374,5449689,4733179.0,716510.0,16747397857,16466581983,104078766857.0,239436067.0,
20110629,16809796611,858850391,656043700.0,202806691.0,120598921,11266552,4031312,5211134.0,-1179822.0,16930395532,16689197690,99355205433.0,220241976.0,
20110630,17124281108,1040052866,725568369.0,314484497.0,131300405,11193673,5586823,5659702.0,-72879.0,17255581513,16992980703,103221420139.0,269116232.0,
20110701,17284258925,924432426,764454609.0,159977817.0,126466709,9895063,3314300,4612910.0,-1298610.0,17410725634,17157792216,105356353346.0,187990666.0,
20110704,17323611660,1166307857,1126955122.0,39352735.0,152657402,12854616,5022068,2062515.0,2959553.0,17476269062,17170954258,143616857336.0,348202190.0,
20110705,17383762436,922968515,862817739.0,60150776.0,138735839,11443964,4495776,5906428.0,-1410652.0,17522498275,17245026597,128562546888.0,393953298.0,
20110706,17663982481,986207992,705987947.0,280220045.0,120444365,8978645,2794260,5259579.0,-2465319.0,17784426846,17543538116,122461075484.0,290244772.0,
20110707,17758752144,1120177136,1025407473.0,94769663.0,128926937,10090018,5285068,4173695.0,1111373.0,17887679081,17629825207,139934074772.0,357900953.0,
20110708,17776243573,836312390,818820961.0,17491429.0,123145684,9576651,3327510,3840877.0,-513367.0,17899389257,17653097889,102596081886.0,307207293.0,
20110711,17917092953,703189744,562340364.0,140849380.0,120987808,9106733,2281816,2751734.0,-469918.0,18038080761,17796105145,101427309779.0,323999656.0,
20110712,17997153779,882517355,802456529.0,80060826.0,96865179,7666637,1397483,2837579.0,-1440096.0,18094018958,17900288600,111173387749.0,481467719.0,
20110713,18208652416,810911250,599412613.0,211498637.0,107247652,8339733,4194816,3521720.0,673096.0,18315900068,18101404764,107537362003.0,364202955.0,
20110714,18255187388,941410724,894875752.0,46534972.0,118056602,10004823,7088673,5423583.0,1665090.0,18373243990,18137130786,125723118602.0,370815114.0,
20110715,18253511171,898096392,899772609.0,-1676217.0,124866183,11091762,4445765,3358826.0,1086939.0,18378377354,18128644988,128004997888.0,282379866.0,
20110718,18533214237,938114982,658411916.0,279703066.0,118284743,10626146,4400937,4866553.0,-465616.0,18651498980,18414929494,129354717992.0,276762222.0,
20110719,18721052787,869512293,681673743.0,187838550.0,116105702,9226150,4966708,6366704.0,-1399996.0,18837158489,18604947085,110081783026.0,264815721.0,
20110720,18904053734,753245170,570244223.0,183000947.0,104270653,8025978,2273105,3473277.0,-1200172.0,19008324387,18799783081,99623518600.0,251865042.0,
20110721,19064469706,794485438,634069466.0,160415972.0,103321745,7927616,2763768,2862130.0,-98362.0,19167791451,18961147961,95834356333.0,219593618.0,
20110722,19089884281,538622268,513207693.0,25414575.0,109482316,8038123,2046281,1935774.0,110507.0,19199366597,18980401965,82429416164.0,219858354.0,
20110725,19407400892,1223685970,906169359.0,317516611.0,90912525,7053850,5661279,6645552.0,-984273.0,19498313417,19316488367,120427061684.0,447233464.0,
20110726,19521197009,600132078,486335961.0,113796117.0,91989898,6979343,4838398,4912905.0,-74507.0,19613186907,19429207111,79443782100.0,214437833.0,
20110727,19723552899,710416333,508060443.0,202355890.0,91618285,7058607,4154342,4075078.0,79264.0,19815171184,19631934614,91952931886.0,254877321.0,
20110728,19687768485,729220145,765004559.0,-35784414.0,89444658,6158003,2856995,3757599.0,-900604.0,19777213143,19598323827,90324090851.0,250399133.0,
20110729,19559824766,599191915,727135634.0,-127943719.0,99044215,7444958,7700455,6413500.0,1286955.0,19658868981,19460780551,83571550253.0,225110676.0,
20110801,19710659516,526493233,375658483.0,150834750.0,94262148,6757289,3564907,4252576.0,-687669.0,19804921664,19616397368,66015286074.0,186238283.0,
20110802,19875147783,587232237,422743970.0,164488267.0,80459862,5634766,3827179,4949702.0,-1122523.0,19955607645,19794687921,77816921640.0,244254455.0,
20110803,19947338610,517125110,444934283.0,72190827.0,84927100,6009484,2512125,2137407.0,374718.0,20032265710,19862411510,73360922142.0,196589446.0,
20110804,19916978654,425657196,456017152.0,-30359956.0,88632479,6177709,1934766,1766541.0,168225.0,20005611133,19828346175,69321891671.0,243518006.0,
20110805,19903220315,732342442,746100781.0,-13758339.0,81846166,6236968,4610775,4551516.0,59259.0,19985066481,19821374149,87498567571.0,453278397.0,
20110808,19965951464,1069167394,1006436245.0,62731149.0,84548175,6228649,6829971,6838290.0,-8319.0,20050499639,19881403289,116947039444.0,652800062.0,
20110809,19958893276,928507380,935565568.0,-7058188.0,103220280,8510822,9821263,7539090.0,2282173.0,20062113556,19855672996,107295711771.0,455261333.0,
20110810,19891797252,722853204,789949228.0,-67096024.0,102750046,8164476,6358839,6705185.0,-346346.0,19994547298,19789047206,103758603514.0,316666222.0,
20110811,19853845619,734314619,772266252.0,-37951633.0,118858307,10015140,9749563,7898899.0,1850664.0,19972703926,19734987312,99981745635.0,242392462.0,
20110812,19780555772,613786247,687076094.0,-73289847.0,100761200,8721815,5604528,6897853.0,-1293325.0,19881316972,19679794572,99952693746.0,256767669.0,
20110815,19900155759,753176441,633576454.0,119599987.0,138610368,12740168,7811496,3793143.0,4018353.0,20038766127,19761545391,90942419051.0,185638565.0,
20110816,19938522613,667246061,628879207.0,38366854.0,119343076,11029909,5334915,7045174.0,-1710259.0,20057865689,19819179537,90391822668.0,219369102.0,
20110817,20020240955,543389929,461671587.0,81718342.0,121490686,11401958,5960696,5588647.0,372049.0,20141731641,19898750269,72061631650.0,183464858.0,
20110818,20125765773,551565624,446040806.0,105524818.0,102841701,9341227,2849491,4910222.0,-2060731.0,20228607474,20022924072,76890223552.0,158405022.0,
20110819,20074117205,651203376,702851944.0,-51648568.0,105792568,9616532,5616951,5341646.0,275305.0,20179909773,19968324637,73534464899.0,237436799.0,
20110822,20104631668,558701490,528187027.0,30514463.0,105877958,9545426,3715579,3786685.0,-71106.0,20210509626,19998753710,65348024666.0,213327326.0,
20110823,20161763673,533358619,476226614.0,57132005.0,119578438,10029143,5461264,4977547.0,483717.0,20281342111,20042185235,63071687188.0,218656216.0,
20110824,20148223867,612218009,625757815.0,-13539806.0,124292110,10600253,4595203,4024093.0,571110.0,20272515977,20023931757,70598924782.0,193989283.0,
20110825,19909811437,1096244617,1334657047.0,-238412430.0,178337878,18118303,19696022,12177972.0,7518050.0,20088149315,19731473559,104629118986.0,253725746.0,
20110826,20109341830,779339684,579809291.0,199530393.0,144852223,14260666,4749623,8607260.0,-3857637.0,20254194053,19964489607,81495000291.0,108232150.0,
20110829,20496342307,924883740,537883263.0,387000477.0,138195444,14198005,6936504,6999165.0,-62661.0,20634537751,20358146863,79732613904.0,131871902.0,
20110830,20749898186,941988987,688433108.0,253555879.0,144874603,15575374,8519795,7142426.0,1377369.0,20894772789,20605023583,79947687891.0,169021591.0,
20110831,20893312611,631883913,488469488.0,143414425.0,156151205,14817593,5352129,6109910.0,-757781.0,21049463816,20737161406,62184232228.0,206066628.0,
20110901,20898889032,591419508,585843087.0,5576421.0,170124255,16459049,6978877,5337421.0,1641456.0,21069013287,20728764777,59905312124.0,251698164.0,
20110902,20901163881,513088861,510814012.0,2274849.0,148371813,15842578,4677930,5294401.0,-616471.0,21049535694,20752792068,55919871012.0,153802142.0,
20110905,21003486998,544363500,442040383.0,102323117.0,151286436,15756419,4891217,4977376.0,-86159.0,21154773434,20852200562,56304848101.0,139526246.0,
20110906,21068944086,538935703,473478615.0,65457088.0,140792805,15441020,6705595,7020994.0,-315399.0,21209736891,20928151281,50030332960.0,116435324.0,
20110907,21042304936,545203523,571842673.0,-26639150.0,137647700,13341862,7934344,10033502.0,-2099158.0,21179952636,20904657236,61930780959.0,154938259.0,
20110908,21114896834,426969613,354377715.0,72591898.0,119523196,11230126,2851131,4962867.0,-2111736.0,21234420030,20995373638,59963300322.0,114085453.0,
20110909,21041870266,456447707,529474275.0,-73026568.0,123040515,11242329,4718266,4706063.0,12203.0,21164910781,20918829751,53482335161.0,97798137.0,
20110913,21122136936,496754054,416487384.0,80266670.0,135897276,13236777,5736074,3741626.0,1994448.0,21258034212,20986239660,51928229328.0,122443676.0,
20110914,21050929175,578762129,649969890.0,-71207761.0,141502534,13571790,8655411,8320398.0,335013.0,21192431709,20909426641,54877281878.0,150988628.0,
20110915,20996390466,520749456,575288165.0,-54538709.0,153849633,15301780,6723858,4993868.0,1729990.0,21150240099,20842540833,55773764806.0,162396038.0,
20110916,21020934154,481260309,456716621.0,24543688.0,152059454,14739963,3733105,4294922.0,-561817.0,21172993608,20868874700,49530435607.0,119809427.0,
20110919,21103835093,477718941,394818002.0,82900939.0,149393710,15411506,5293501,4621958.0,671543.0,21253228803,20954441383,48628044450.0,126657755.0,
20110920,21181592617,498228852,420471328.0,77757524.0,143514609,14239386,5818837,6990957.0,-1172120.0,21325107226,21038078008,48002479495.0,102921176.0,
20110921,21080852830,954136977,1054876764.0,-100739787.0,206591595,21524918,12898976,5613444.0,7285532.0,21287444425,20874261235,88088505298.0,253301025.0,
20110922,21403223921,1069294786,746923695.0,322371091.0,130053405,14441300,4620321,11703939.0,-7083618.0,21533277326,21273170516,74788301582.0,190281374.0,
20110923,21359329274,725289704,769184351.0,-43894647.0,120866382,13089962,8825812,10177150.0,-1351338.0,21480195656,21238462892,67796459668.0,198468090.0,
20110926,21304984798,770319061,824663537.0,-54344476.0,139292010,14219544,10197700,9068118.0,1129582.0,21444276808,21165692788,58761018136.0,206775641.0,
20110927,21442994144,798225193,660215847.0,138009346.0,137037016,13724995,8993687,9488236.0,-494549.0,21580031160,21305957128,55475490582.0,155994105.0,
20110928,21285200989,589898985,747692140.0,-157793155.0,138656353,14122313,8666246,8268928.0,397318.0,21423857342,21146544636,55706664716.0,137371717.0,
20110929,21137792643,607797098,755205444.0,-147408346.0,114029122,11299531,8060878,10883660.0,-2822782.0,21251821765,21023763521,57055310100.0,149691456.0,
20110930,20678257223,492770036,952305456.0,-459535420.0,103619722,10440824,5937150,6795857.0,-858707.0,20781876945,20574637501,45993433075.0,120175420.0,
20111010,20500158665,563518759,741617317.0,-178098558.0,127729044,13608090,6471754,3304488.0,3167266.0,20627887709,20372429621,39902178050.0,106299691.0,
20111011,20324309699,818716848,994565814.0,-175848966.0,164383113,16966515,14579542,11221117.0,3358425.0,20488692812,20159926586,62649919980.0,215143351.0,
20111012,20430753257,1268675776,1162232218.0,106443558.0,197808881,20463760,17590680,14093435.0,3497245.0,20628562138,20232944376,84336881332.0,408984507.0,
20111013,20543903238,1004156009,891006028.0,113149981.0,189604710,19387268,10184680,11261172.0,-1076492.0,20733507948,20354298528,82143297581.0,251144178.0,
20111014,20400802814,566964409,710064833.0,-143100424.0,173236358,18130701,7224172,8480739.0,-1256567.0,20574039172,20227566456,58393308956.0,133097694.0,
20111017,20300361995,615448397,715889216.0,-100440819.0,224636776,22424092,9809467,5516076.0,4293391.0,20524998771,20075725219,57605765237.0,130026787.0,
20111018,20246908676,767490712,820944031.0,-53453319.0,201356530,20821522,9000481,10603051.0,-1602570.0,20448265206,20045552146,69515520975.0,155626395.0,
20111019,20242841224,560816548,564884000.0,-4067452.0,214840500,21272854,9326280,8874948.0,451332.0,20457681724,20028000724,53161251967.0,107298426.0,
20111020,20274135425,763089420,731795219.0,31294201.0,202598780,19965227,12806994,14114621.0,-1307627.0,20476734205,20071536645,57832337902.0,169223616.0,
20111021,20077609862,435631187,632156750.0,-196525563.0,211420624,21500417,8870038,7334848.0,1535190.0,20289030486,19866189238,43839424544.0,82603021.0,
20111024,19813181984,665327297,929755175.0,-264427878.0,277010395,29481990,16458480,8476907.0,7981573.0,20090192379,19536171589,62816330934.0,177800140.0,
20111025,19857163052,1013477891,969496823.0,43981068.0,275098742,27805778,11529889,13206101.0,-1676212.0,20132261794,19582064310,83631512403.0,213812370.0,
20111026,19786668727,1186801201,1257295526.0,-70494325.0,278027139,25867196,11895931,13834513.0,-1938582.0,20064695866,19508641588,98483766302.0,236955751.0,
20111027,19930731684,866055881,721992924.0,144062957.0,269320285,25870085,8478125,8475236.0,2889.0,20200051969,19661411399,75162409916.0,213371518.0,
20111028,19749284408,1317088917,1498536193.0,-181447276.0,280412541,24563599,14722998,16029484.0,-1306486.0,20029696949,19468871867,104013795456.0,295079954.0,
20111031,19901349449,848254260,696189219.0,152065041.0,289607069,28142824,12563771,8984546.0,3579225.0,20190956518,19611742380,81588239364.0,220519239.0,
20111101,20008002941,1034962228,928308736.0,106653492.0,311177544,26987151,13416001,14571674.0,-1155673.0,20319180485,19696825397,85504804285.0,195242935.0,
20111102,20094724795,1186052906,1099331052.0,86721854.0,324025976,29986982,16013940,13014109.0,2999831.0,20418750771,19770698819,102314412060.0,253681472.0,
20111103,20365235328,1715745986,1445235453.0,270510533.0,350922118,31206137,12683294,11464139.0,1219155.0,20716157446,20014313210,136988643309.0,307154805.0,
20111104,20425574366,1033452397,973113359.0,60339038.0,313367437,26947593,8369940,12628484.0,-4258544.0,20738941803,20112206929,100177535793.0,216530247.0,
20111107,20693207005,948486415,680853776.0,267632639.0,291959397,26955213,9635057,9627437.0,7620.0,20985166402,20401247608,79545576060.0,140702515.0,
20111108,20904972932,899090697,687324770.0,211765927.0,282879218,26772166,10627240,10810287.0,-183047.0,21187852150,20622093714,77238714975.0,132574946.0,
20111109,21137377041,941665090,709260981.0,232404109.0,274341766,26167383,9004068,9608851.0,-604783.0,21411718807,20863035275,78111353743.0,194498767.0,
20111110,21382370001,988495911,743502951.0,244992960.0,251366496,24396868,8554810,10325325.0,-1770515.0,21633736497,21131003505,85930439115.0,172780770.0,
20111111,21345143945,522265203,559491259.0,-37226056.0,228553808,21814465,6117291,8699694.0,-2582403.0,21573697753,21116590137,65146666756.0,107228544.0,
20111114,21472109836,975365770,848399879.0,126965891.0,283122754,26773711,10944894,5985648.0,4959246.0,21755232590,21188987082,82534969901.0,206403417.0,
20111115,21642895602,779370039,608584273.0,170785766.0,273247991,27080435,7269674,6962950.0,306724.0,21916143593,21369647611,80505887300.0,177820193.0,
20111116,22079287311,1219956202,783564493.0,436391709.0,239721422,26259470,9295086,10116051.0,-820965.0,22319008733,21839565889,92479969946.0,241435950.0,
20111117,22110549167,648788840,617526984.0,31261856.0,227849268,26273433,7134576,7120613.0,13963.0,22338398435,21882699899,66151353111.0,163709625.0,
20111118,22128264632,780915845,763200380.0,17715465.0,222239814,24522714,10335910,12086629.0,-1750719.0,22350504446,21906024818,71156491299.0,220761066.0,
20111121,22261866663,559758089,426156058.0,133602031.0,199896201,22621233,6876944,8778425.0,-1901481.0,22461762864,22061970462,49599768042.0,127058106.0,
20111122,22340596474,525422181,446692370.0,78729811.0,222145112,25818227,10996422,7799428.0,3196994.0,22562741586,22118451362,50558334446.0,134967708.0,
20111123,22381342035,531977490,491231929.0,40745561.0,226185197,25511851,7883063,8189439.0,-306376.0,22607527232,22155156838,50170690969.0,122873866.0,
20111124,22421973306,533808677,493177406.0,40631271.0,222336516,26046976,10427210,9892085.0,535125.0,22644309822,22199636790,51668606780.0,111931468.0,
20111125,22400850427,378427898,399550777.0,-21122879.0,229398872,24411174,6142342,7778144.0,-1635802.0,22630249299,22171451555,46744633298.0,131610659.0,
20111128,22494897616,416782437,322735248.0,94047189.0,237443922,23766060,8508862,9153976.0,-645114.0,22732341538,22257453694,46525772067.0,104139024.0,
20111129,22518644243,523651456,499904829.0,23746627.0,243157210,23939304,6499083,6325839.0,173244.0,22761801453,22275487033,57577011349.0,151469755.0,
20111130,22466452028,671042821,723235036.0,-52192215.0,251839752,25789420,13718818,11868702.0,1850116.0,22718291780,22214612276,71879125982.0,510856060.0,
20111201,22299466764,1146806646,1313791910.0,-166985264.0,323600241,31414320,23831887,18206987.0,5624900.0,22623067005,21975866523,95018565078.0,406508556.0,
20111202,22267766625,591659988,623360127.0,-31700139.0,286192505,25798251,11811426,17427495.0,-5616069.0,22553959130,21981574120,57153903567.0,206013020.0,
20111205,22379650562,875782534,763898597.0,111883937.0,285651059,28770860,11485770,8513161.0,2972609.0,22665301621,22093999503,48679159919.0,169842387.0,
20111206,22413359472,596412942,562704032.0,33708910.0,323513134,30294629,12894247,11370478.0,1523769.0,22736872606,22089846338,42572583051.0,148816983.0,
20111207,22449261088,604856537,568954921.0,35901616.0,355100811,32517630,12002880,9779879.0,2223001.0,22804361899,22094160277,39684792596.0,121549085.0,
20111208,22528992922,675914693,596182859.0,79731834.0,348107592,31650642,13511857,14378845.0,-866988.0,22877100514,22180885330,49369585059.0,128806504.0,
20111209,22507138358,566831017,588685581.0,-21854564.0,331965565,31101894,12314384,12863132.0,-548748.0,22839103923,22175172793,38827825498.0,85750564.0,
20111212,22525065787,554603321,536675892.0,17927429.0,347531224,33629217,14426092,11898769.0,2527323.0,22872597011,22177534563,36617631938.0,70146895.0,
20111213,22643584951,833397363,714878199.0,118519164.0,307393822,32193838,18470026,19905405.0,-1435379.0,22950978773,22336191129,51520368717.0,147737819.0,
20111214,22710676753,632941142,565849340.0,67091802.0,330633736,35419573,18636350,15410615.0,3225735.0,23041310489,22380043017,38557564226.0,87595850.0,
20111215,22829426940,963186538,844436351.0,118750187.0,272303088,28592270,21056484,27883787.0,-6827303.0,23101730028,22557123852,47652092493.0,162469046.0,
20111216,22960970432,860810024,729266532.0,131543492.0,305995652,30758385,21208854,19042739.0,2166115.0,23266966084,22654974780,50704953065.0,126959878.0,
20111219,23160945470,822981905,623006867.0,199975038.0,332957773,33105978,24292388,21944795.0,2347593.0,23493903243,22827987697,49685453474.0,102717484.0,
20111220,23215304975,728256469,673896964.0,54359505.0,360845947,34861389,15958852,14203441.0,1755411.0,23576150922,22854459028,47013788968.0,123671625.0,
20111221,23213182571,747255578,749377982.0,-2122404.0,377163348,37184408,20155441,17832422.0,2323019.0,23590345919,22836019223,46051956945.0,114206917.0,
20111222,23156209497,712315873,769288947.0,-56973074.0,379727180,37859438,25005463,24330433.0,675030.0,23535936677,22776482317,48868702529.0,154986323.0,
20111223,23022628028,606711079,740292548.0,-133581469.0,376194331,37405942,23217806,23671302.0,-453496.0,23398822359,22646433697,44325003865.0,288273987.0,
20111226,23097117469,581463956,506974515.0,74489441.0,416766360,44732221,25980338,18654059.0,7326279.0,23513883829,22680351109,36495586878.0,54779525.0,
20111227,23125457645,595501546,567161370.0,28340176.0,404473909,42098722,22763301,25396800.0,-2633499.0,23529931554,22720983736,37583231436.0,105467871.0,
20111228,23227075749,640946990,539328886.0,101618104.0,363621020,39661774,26680606,29117554.0,-2436948.0,23590696769,22863454729,40307365848.0,102091205.0,
20111229,23261484479,635606065,601197335.0,34408730.0,376407550,41815062,20787029,18633741.0,2153288.0,23637892029,22885076929,36378476228.0,95104938.0,
20111230,23163493473,762689122,860680128.0,-97991006.0,381308271,42775775,16111293,15150580.0,960713.0,23544801744,22782185202,42904178710.0,87107146.0,
20120104,23086161879,788064877,865396471.0,-77331594.0,420191819,46400139,23909849,20285485.0,3624364.0,23506353698,22665970060,40970784142.0,99112293.0,
20120105,22871007499,794286091,1009440471.0,-215154380.0,442507556,50717382,33093226,28775983.0,4317243.0,23313515055,22428499943,46559738711.0,111385287.0,
20120106,22974795499,825709884,721921884.0,103788000.0,424102079,46360925,28232074,32588531.0,-4356457.0,23398897578,22550693420,39386609758.0,111099492.0,
20120109,22853440665,1130784004,1252138838.0,-121354834.0,493659623,53940103,36755697,29176519.0,7579178.0,23347100288,22359781042,62162426797.0,196586673.0,
20120110,22773950655,1701133654,1780623664.0,-79490010.0,542466054,60754782,36201132,29386453.0,6814679.0,23316416709,22231484601,91006900286.0,252579387.0,
20120111,22869720240,1274706955,1178937370.0,95769585.0,484380898,54570044,22465195,28649933.0,-6184738.0,23354101138,22385339342,74433602108.0,234794598.0,
20120112,22781226572,1231619261,1320112929.0,-88493668.0,518981025,55347593,25652667,24875118.0,777549.0,23300207597,22262245547,63861280793.0,169714301.0,
20120113,22674391245,1133649934,1240485261.0,-106835327.0,472373707,53783886,32020707,33584414.0,-1563707.0,23146764952,22202017538,63897043949.0,145400910.0,
20120116,22638911372,878056969,913536842.0,-35479873.0,482314622,55948078,23390485,21226293.0,2164192.0,23121225994,22156596750,42893908843.0,86700124.0,
20120117,22582606058,1651314781,1707620095.0,-56305314.0,472151600,58887823,44605354,41665609.0,2939745.0,23054757658,22110454458,77232162893.0,205620567.0,
20120118,22564638461,1581544852,1599512449.0,-17967597.0,462490757,58523016,27677343,28042150.0,-364807.0,23027129218,22102147704,80696670384.0,157555412.0,
20120119,22161798417,1384432993,1787273037.0,-402840044.0,469400533,55687161,34258703,37094558.0,-2835855.0,22631198950,21692397884,63797340035.0,137284273.0,
20120120,21088647331,1142179973,2215331059.0,-1073151086.0,465817218,55586416,26347917,26448662.0,-100745.0,21554464549,20622830113,62761999689.0,144416034.0,
20120130,21653344631,1502767818,938070518.0,564697300.0,517342115,61608639,27449182,21426959.0,6022223.0,22170686746,21136002516,51760251300.0,130588455.0,
20120131,22014346641,1044338505,683336495.0,361002010.0,516870389,65089079,25851288,22370848.0,3480440.0,22531217030,21497476252,43786606784.0,122843865.0,
20120201,22366485298,1285617462,933478805.0,352138657.0,499224550,62171415,29621146,32538810.0,-2917664.0,22865709848,21867260748,48467424395.0,187610594.0,
20120202,22396236472,1178861936,1149110762.0,29751174.0,616095248,74944712,40883119,28109822.0,12773297.0,23012331720,21780141224,57557865345.0,153545038.0,
20120203,22515446802,1520410924,1401200594.0,119210330.0,614937122,72249383,28466238,31161567.0,-2695329.0,23130383924,21900509680,70120766083.0,151685118.0,
20120206,22784517940,1343935156,1074864018.0,269071138.0,647383244,79203248,30082272,23128407.0,6953865.0,23431901184,22137134696,67216791550.0,150277690.0,
20120207,23313248252,1445701790,916971478.0,528730312.0,547716962,67519882,23234560,34917926.0,-11683366.0,23860965214,22765531290,58016352447.0,129630395.0,
20120208,23304347745,1565565996,1574466503.0,-8900507.0,626032158,76405228,42850739,33965393.0,8885346.0,23930379903,22678315587,80888934872.0,175970435.0,
20120209,23364280534,1737119914,1677187125.0,59932789.0,614904727,73917036,24235925,26724117.0,-2488192.0,23979185261,22749375807,89493953892.0,209725891.0,
20120210,23186699954,1445006748,1622587328.0,-177580580.0,644878993,77934173,37539934,33522797.0,4017137.0,23831578947,22541820961,82252605985.0,194541579.0,
20120213,23608213305,1582126178,1160612827.0,421513351.0,607362447,74001887,27428688,31360974.0,-3932286.0,24215575752,23000850858,77803602391.0,107353256.0,
20120214,23860965648,1256560815,1003808472.0,252752343.0,579118989,67425776,21818417,28394528.0,-6576111.0,24440084637,23281846659,66366467556.0,115078544.0,
20120215,24179753364,1781362196,1462574480.0,318787716.0,601734232,70206203,33021804,30241377.0,2780427.0,24781487596,23578019132,87504427084.0,185631070.0,
20120216,24491754154,1582477398,1270476608.0,312000790.0,590145157,67354573,29591666,32443296.0,-2851630.0,25081899311,23901608997,83766892949.0,166478502.0,
20120217,24478237341,1179539111,1193055924.0,-13516813.0,576582374,67342330,21536477,21548720.0,-12243.0,25054819715,23901654967,65018550106.0,153912426.0,
20120220,24772829932,1759766700,1465174109.0,294592591.0,579980747,67006375,25030078,25366033.0,-335955.0,25352810679,24192849185,82125525099.0,183195229.0,
20120221,24969797018,1563224989,1366257903.0,196967086.0,604735691,67474234,28384179,27916320.0,467859.0,25574532709,24365061327,74446844794.0,139099275.0,
20120222,25223728541,2434752756,2180821233.0,253931523.0,648311438,71213515,33399169,29659888.0,3739281.0,25872039979,24575417103,109266836399.0,215886440.0,
20120223,25509973452,2185981378,1899736467.0,286244911.0,658672185,74545206,29827061,26495370.0,3331691.0,26168645637,24851301267,105322859300.0,183851827.0,
20120224,25607219924,2713861391,2616614919.0,97246472.0,715901888,79216645,38356889,33685450.0,4671439.0,26323121812,24891318036,121343377231.0,326203311.0,
20120227,25953096751,3344833427,2998956600.0,345876827.0,749953321,84073278,40228327,35371694.0,4856633.0,26703050072,25203143430,144883446035.0,348385591.0,
20120228,26173607268,2196625510,1976114993.0,220510517.0,723104224,87665091,35380084,31788271.0,3591813.0,26896711492,25450503044,107087536025.0,250911174.0,
20120229,26421186475,2001683188,1754103981.0,247579207.0,618905567,69376741,21241505,39529855.0,-18288350.0,27040092042,25802280908,91634073829.0,322175747.0,
20120301,26693098407,1544104350,1272192418.0,271911932.0,599587277,66158703,18384913,21602951.0,-3218038.0,27292685684,26093511130,71358309787.0,160277533.0,
20120302,27048735068,2290381860,1934745199.0,355636661.0,651310699,68726983,32257235,29688955.0,2568280.0,27700045767,26397424369,96678139821.0,220504543.0,
20120305,27545673775,2328139500,1831200793.0,496938707.0,661468241,69480404,23245402,22491981.0,753421.0,28207142016,26884205534,108098666650.0,229185459.0,
20120306,27925437822,2260379699,1880615652.0,379764047.0,576731626,57613626,22969708,34836486.0,-11866778.0,28502169448,27348706196,100532936213.0,273389885.0,
20120307,28322835473,2037715180,1640317529.0,397397651.0,572080706,60969711,27513496,24157411.0,3356085.0,28894916179,27750754767,91655726860.0,219806327.0,
20120308,28553279578,2004963445,1774519340.0,230444105.0,617717954,65148944,30877433,26698200.0,4179233.0,29170997532,27935561624,93200009353.0,344492961.0,
20120309,28698907823,2039557422,1893929177.0,145628245.0,627719200,68860749,27333645,23621840.0,3711805.0,29326627023,28071188623,100502489833.0,265316989.0,
20120312,29313541336,2466695709,1852062196.0,614633513.0,624485011,67451971,21119382,22528160.0,-1408778.0,29938026347,28689056325,108191513309.0,186796106.0,
20120313,29506123404,2090953160,1898371092.0,192582068.0,650512180,69587560,26611167,24475578.0,2135589.0,30156635584,28855611224,103047806952.0,296508805.0,
20120314,29962495014,3971920425,3515548815.0,456371610.0,583607249,69025989,49997459,50559030.0,-561571.0,30546102263,29378887765,170495335034.0,487834650.0,
20120315,30030622336,2615937639,2547810317.0,68127322.0,553397981,59941649,32707021,41791361.0,-9084340.0,30584020317,29477224355,112429834572.0,284151216.0,
20120316,30040251162,1990283308,1980654482.0,9628826.0,560756438,54580030,28742946,34104565.0,-5361619.0,30601007600,29479494724,102294850124.0,218294093.0,
20120319,30589579776,2323158537,1773829923.0,549328614.0,578814778,56181903,27401075,25799202.0,1601873.0,31168394554,30010764998,107122287735.0,195352803.0,
20120320,30881415456,2213237546,1921401866.0,291835680.0,538233515,56871972,30913007,30222938.0,690069.0,31419648971,30343181941,94460766541.0,193263998.0,
20120321,31184318827,2250811673,1947908302.0,302903371.0,524894386,54813928,35619553,37677597.0,-2058044.0,31709213213,30659424441,95242944751.0,161759732.0,
20120322,31258610141,1552432938,1478141624.0,74291314.0,539410434,57970650,31317968,28161246.0,3156722.0,31798020575,30719199707,77280136739.0,176393433.0,
20120323,31324525878,1588669351,1522753614.0,65915737.0,501264079,48785242,26483738,35669146.0,-9185408.0,31825789957,30823261799,73914124487.0,240659952.0,
20120326,31310255462,1024520698,1038791114.0,-14270416.0,500457946,46497850,23866413,26153805.0,-2287392.0,31810713408,30809797516,54081927217.0,123112833.0,
20120327,31652995174,1639570640,1296830928.0,342739712.0,506940846,49559003,27388022,24326869.0,3061153.0,32159936020,31146054328,65158935830.0,117865639.0,
20120328,31725359177,1803704771,1731340768.0,72364003.0,472971028,48674164,42376494,43261333.0,-884839.0,32198330205,31252388149,78012288453.0,230705476.0,
20120329,31466692094,1468201404,1726868487.0,-258667083.0,451280109,44127042,46667617,51214739.0,-4547122.0,31917972203,31015411985,68042959698.0,161645888.0,
20120330,30855059829,1118746389,1730378654.0,-611632265.0,498505368,56193346,62941195,50874891.0,12066304.0,31353565197,30356554461,55952210856.0,134912603.0,
20120405,31036889547,1910713961,1728884243.0,181829718.0,612979847,64586644,56598239,48204941.0,8393298.0,31649869394,30423909700,74665567053.0,163350953.0,
20120406,31203189503,1556670352,1390370396.0,166299956.0,638010186,73395741,46986690,38177593.0,8809097.0,31841199689,30565179317,69051871355.0,126034239.0,
20120409,31312683905,1263660302,1154165900.0,109494402.0,637822011,68770210,47806726,52432257.0,-4625531.0,31950505916,30674861894,55080622300.0,101900657.0,
20120410,31315108010,1442581118,1440157013.0,2424105.0,613613548,73810230,80355809,75315789.0,5040020.0,31928721558,30701494462,63049407544.0,126129640.0,
20120411,31650530805,1620531132,1285108337.0,335422795.0,637539984,79068442,55313390,50055178.0,5258212.0,32288070789,31012990821,67242070780.0,312712214.0,
20120412,31658371384,2069068142,2061227563.0,7840579.0,728861977,99941076,80194978,59322344.0,20872634.0,32387233361,30929509407,87134354070.0,218478933.0,
20120413,31321457781,1929005224,2265918827.0,-336913603.0,724919491,103454520,42290928,38777484.0,3513444.0,32046377272,30596538290,92369881177.0,201405244.0,
20120416,31551930384,1690206798,1459734195.0,230472603.0,745742224,99357507,40483930,44580943.0,-4097013.0,32297672608,30806188160,73766159677.0,145600612.0,
20120417,31701763328,1522188706,1372355762.0,149832944.0,644509653,75021384,28548563,52884686.0,-24336123.0,32346272981,31057253675,72338690918.0,164054607.0,
20120418,31713063485,2056222445,2044922288.0,11300157.0,742347355,94973520,68153995,48201859.0,19952136.0,32455410840,30970716130,93102836503.0,207948454.0,
20120419,31763708953,2086454193,2035808725.0,50645468.0,745588191,95252379,36252010,35973151.0,278859.0,32509297144,31018120762,90043752088.0,122919960.0,
20120420,31697962487,2307629393,2373375859.0,-65746466.0,799575812,107583581,65626841,53295639.0,12331202.0,32497538299,30898386675,101635075190.0,137036506.0,
20120423,31919290664,2418725607,2197397430.0,221328177.0,740475666,93581898,33113154,47114837.0,-14001683.0,32659766330,31178814998,109256961845.0,592993686.0,
20120424,31886526859,2842912506,2875676311.0,-32763805.0,698699325,89615736,100606915,104573077.0,-3966162.0,32585226184,31187827534,117336858497.0,426244657.0,
20120425,32022808570,2546857177,2410575466.0,136281711.0,733448615,95956860,77263596,70922472.0,6341124.0,32756257185,31289359955,113045830242.0,268691484.0,
20120426,32207563433,2491763979,2307009116.0,184754863.0,711808798,92790440,61307519,64473939.0,-3166420.0,32919372231,31495754635,104978254050.0,217754449.0,
20120427,31996092316,1870375931,2081847048.0,-211471117.0,652371267,75102834,44197746,61885352.0,-17687606.0,32648463583,31343721049,84104021068.0,206013799.0,
20120502,32374252299,3738262191,3360102208.0,378159983.0,762654074,102616917,96784966,69270883.0,27514083.0,33136906373,31611598225,124250918500.0,369078561.0,
20120503,32914444024,2695216589,2155024864.0,540191725.0,797696945,100602257,55100759,57115419.0,-2014660.0,33712140969,32116747079,102881510787.0,189911507.0,
20120504,32929079712,2390138078,2375502390.0,14635688.0,793584355,94427325,44620428,50795360.0,-6174932.0,33722664067,32135495357,102397248133.0,263491097.0,
20120507,33467500884,2716734348,2178313176.0,538421172.0,728200355,93667450,47121086,47880961.0,-759875.0,34195701239,32739300529,111406047977.0,213189559.0,
20120508,33893622504,2441135022,2015013402.0,426121620.0,722745535,89363763,46747769,51051456.0,-4303687.0,34616368039,33170876969,105315900535.0,207014927.0,
20120509,34451948648,2651766271,2093440127.0,558326144.0,625816606,70429182,31970137,50904718.0,-18934581.0,35077765254,33826132042,99432058979.0,264844865.0,
20120510,35040860645,2161721639,1572809642.0,588911997.0,622693679,70736344,46438814,46131652.0,307162.0,35663554324,34418166966,81027497023.0,225030235.0,
20120511,35115705765,1960511506,1885666386.0,74845120.0,618124665,72634354,52964430,51066420.0,1898010.0,35733830430,34497581100,75652450458.0,189447566.0,
20120514,35628803242,2461641937,1948544460.0,513097477.0,626430094,83330079,58276789,47581064.0,10695725.0,36255233336,35002373148,89453859431.0,186159633.0,
20120515,36152562663,2036097511,1512338090.0,523759421.0,655470335,76164785,44423368,51588662.0,-7165294.0,36808032998,35497092328,77511255671.0,169238638.0,
20120516,36779217694,2178812217,1552157186.0,626655031.0,646127083,82716723,54455563,47903625.0,6551938.0,37425344777,36133090611,74526877444.0,209132763.0,
20120517,36787680964,1962619901,1954156631.0,8463270.0,715905627,98072503,72488823,57133043.0,15355780.0,37503586591,36071775337,81854394903.0,188152063.0,
20120518,36821357488,1888308119,1854631595.0,33676524.0,650247666,79483011,48150091,66739583.0,-18589492.0,37471605154,36171109822,79060591819.0,167139002.0,
20120521,37126490787,1797956959,1492823660.0,305133299.0,691025268,79977463,70327136,69832684.0,494452.0,37817516055,36435465519,70012682864.0,149932622.0,
20120522,37079833553,1671466540,1718123774.0,-46657234.0,792549634,101272872,62123968,40828559.0,21295409.0,37872383187,36287283919,75456858693.0,111757881.0,
20120523,37072055664,1835455665,1843233554.0,-7777889.0,851734986,110405609,63951152,54818415.0,9132737.0,37923790650,36220320678,85186681792.0,108323367.0,
20120524,37528312047,1988441593,1532185210.0,456256383.0,814032820,109119638,48564343,49850314.0,-1285971.0,38342344867,36714279227,77536034297.0,113296292.0,
20120525,37535963602,1497066380,1489414825.0,7651555.0,770189440,99344339,65466655,75241954.0,-9775299.0,38306153042,36765774162,68395775484.0,145864996.0,
20120528,37598761062,1930551399,1867753939.0,62797460.0,770434631,100085549,79788676,79047466.0,741210.0,38369195693,36828326431,86690224949.0,304121907.0,
20120529,37676358273,2823201360,2745604149.0,77597211.0,795978999,102682123,85831190,83234616.0,2596574.0,38472337272,36880379274,111810912874.0,201479641.0,
20120530,37985520066,2248621352,1939459559.0,309161793.0,837500845,96936518,56907028,62652633.0,-5745605.0,38823020911,37148019221,85452129947.0,193998271.0,
20120531,38363704389,2037759682,1659575359.0,378184323.0,762840548,81459868,41239991,56716641.0,-15476650.0,39126544937,37600863841,75478471284.0,194907645.0,
20120601,38393016442,1909782134,1880470081.0,29312053.0,741659426,82324321,48880185,48015732.0,864453.0,39134675868,37651357016,77139154352.0,124900477.0,
20120604,39201386102,2785005768,1976636108.0,808369660.0,674920254,70592507,46517920,58249734.0,-11731814.0,39876306356,38526465848,86785597604.0,190696867.0,
20120605,39341792121,1627172086,1486766067.0,140406019.0,693111890,79361897,72500316,63730926.0,8769390.0,40034904011,38648680231,64054640473.0,97033525.0,
20120606,39585278444,1698621302,1455134979.0,243486323.0,696908292,75901796,55559875,59019976.0,-3460101.0,40282186736,38888370152,58534118005.0,94331962.0,
20120607,39824344326,1889737375,1650671493.0,239065882.0,693817796,80374882,55219901,50746815.0,4473086.0,40518162122,39130526530,59545493696.0,110041252.0,
20120608,39719820736,1805598796,1910122386.0,-104523590.0,707825275,74578434,68552372,74348820.0,-5796448.0,40427646011,39011995461,63847734834.0,126060376.0,
20120611,39915091233,1777895999,1582625502.0,195270497.0,708140329,71278581,69193516,72493369.0,-3299853.0,40623231562,39206950904,60360575899.0,108772242.0,
20120612,40118853209,1626998751,1423236775.0,203761976.0,775286155,86829122,86560332,71009791.0,15550541.0,40894139364,39343567054,55468042358.0,171431928.0,
20120613,40366154559,2136093851,1888792501.0,247301350.0,804450614,88006249,75040967,73863840.0,1177127.0,41170605173,39561703945,73819299751.0,217203738.0,
20120614,40463725268,1596178919,1498608210.0,97570709.0,805817964,91731657,63646404,59920996.0,3725408.0,41269543232,39657907304,69140251760.0,117050918.0,
20120615,40424538156,2362756170,2401943282.0,-39187112.0,752573261,76271115,61302167,76762709.0,-15460542.0,41177111417,39671964895,68651509659.0,234844417.0,
20120618,40774082626,1739591533,1390047063.0,349544470.0,785854699,82028223,53460264,47703156.0,5757108.0,41559937325,39988227927,60001128925.0,600363908.0,
20120619,40959301472,1610403138,1425184292.0,185218846.0,737452012,83848906,50150367,48329684.0,1820683.0,41696753484,40221849460,57825287558.0,234914865.0,
20120620,40971366211,1305051000,1292986261.0,12064739.0,756005017,78687462,32590772,37752216.0,-5161444.0,41727371228,40215361194,50677009320.0,258471746.0,
20120621,41216039765,1827369234,1582695680.0,244673554.0,667886102,72266373,58747926,65169015.0,-6421089.0,41883925867,40548153663,54588415857.0,253133507.0,
20120625,41328073117,1688930079,1576896727.0,112033352.0,638598125,68561048,50582373,54287698.0,-3705325.0,41966671242,40689474992,54526192199.0,450149403.0,
20120626,41366843299,1329392155,1290621973.0,38770182.0,664880194,70170803,55891667,54281912.0,1609755.0,42031723493,40701963105,47413563528.0,194552138.0,
20120627,41452187393,1170928470,1085584376.0,85344094.0,728466579,74432399,47294602,43033006.0,4261596.0,42180653972,40723720814,45257988185.0,133011116.0,
20120628,41554211158,1419503922,1317480157.0,102023765.0,699842311,65864694,41151998,49719703.0,-8567705.0,42254053469,40854368847,50216790842.0,225865870.0,
20120629,41352503305,1575175909,1776883762.0,-201707853.0,748286235,71843529,55266063,49287228.0,5978835.0,42100789540,40604217070,55800703273.0,173107278.0,
20120702,41651551679,1764735984,1465687610.0,299048374.0,807498588,78605198,57944152,51182483.0,6761669.0,42459050267,40844053091,60746364084.0,155885096.0,
20120703,41775297474,1608081585,1484335790.0,123745795.0,835347527,77988261,60616172,61233109.0,-616937.0,42610645001,40939949947,60533304901.0,186939619.0,
20120704,41979741991,1502115984,1297671467.0,204444517.0,859659598,83797944,54962884,49153201.0,5809683.0,42839401589,41120082393,52225392957.0,240728739.0,
20120705,41980089686,1357113618,1356765923.0,347695.0,810716248,76724103,45976417,53050258.0,-7073841.0,42790805934,41169373438,51983184342.0,170893173.0,
20120706,42071500783,2161091737,2069680640.0,91411097.0,809180403,71524787,55643954,60843270.0,-5199316.0,42880681186,41262320380,70665278508.0,202590214.0,
20120709,42433217425,2200692162,1838975520.0,361716642.0,824026113,76491434,65970426,61003779.0,4966647.0,43257243538,41609191312,69296933180.0,222767108.0,
20120710,42677890401,1526392426,1281719450.0,244672976.0,790231037,72108460,51222842,55605816.0,-4382974.0,43468121438,41887659364,53018679546.0,249860501.0,
20120711,42763477754,1400213120,1314625767.0,85587353.0,852955616,79346065,55472817,48235212.0,7237605.0,43616433370,41910522138,53529978141.0,215278412.0,
20120712,42958440250,2685529361,2490566865.0,194962496.0,825305762,86725318,81076191,73696938.0,7379253.0,43783746012,42133134488,79187861628.0,585743188.0,
20120713,42995301769,1496117118,1459255599.0,36861519.0,809010444,73569060,57872324,71028582.0,-13156258.0,43804312213,42186291325,56103650667.0,256134997.0,
20120716,42954857532,1612756321,1653200558.0,-40444237.0,837478653,82744142,63438603,54263521.0,9175082.0,43792336185,42117378879,62621669572.0,142510775.0,
20120717,42850583006,1320741173,1425015699.0,-104274526.0,822312728,87962716,78146872,72928298.0,5218574.0,43672895734,42028270278,51943808099.0,143575587.0,
20120718,43001260903,1706983756,1556305859.0,150677897.0,815806529,87308300,94063890,94718306.0,-654416.0,43817067432,42185454374,59135267960.0,166292170.0,
20120719,43133376716,1899781165,1767665352.0,132115813.0,855940946,87830435,101789166,101267031.0,522135.0,43989317662,42277435770,68257956338.0,193676918.0,
20120720,43293277130,1377290396,1217389982.0,159900414.0,801988558,75563457,81879998,94146976.0,-12266978.0,44095265688,42491288572,54539173705.0,111673947.0,
20120723,43520903617,1270199632,1042573145.0,227626487.0,783217522,79265046,74122637,70421048.0,3701589.0,44304121139,42737686095,48018212992.0,115218307.0,
20120724,43673831708,1164984697,1012056606.0,152928091.0,794241045,78452436,74363842,75176452.0,-812610.0,44468072753,42879590663,46672779861.0,152839062.0,
20120725,43628637939,910461171,955654940.0,-45193769.0,792767238,77500358,61189664,62141742.0,-952078.0,44421405177,42835870701,40951014277.0,312679360.0,
20120726,43605874770,1117458307,1140221476.0,-22763169.0,805110770,81310254,84741539,80931643.0,3809896.0,44410985540,42800764000,45011320923.0,184066493.0,
20120727,43546606535,1164631708,1223899943.0,-59268235.0,776735174,82465871,90590906,89435289.0,1155617.0,44323341709,42769871361,46624657948.0,122134960.0,
20120730,43600788260,1195213435,1141031710.0,54181725.0,773619516,82041470,88269715,88694116.0,-424401.0,44374407776,42827168744,42289964268.0,321456276.0,
20120731,43397313276,1164959004,1368433988.0,-203474984.0,819409782,87036316,95425038,90430192.0,4994846.0,44216723058,42577903494,43334539039.0,232479155.0,
20120801,43473512880,1328778018,1252578414.0,76199604.0,846108824,87744284,93231902,92523934.0,707968.0,44319621704,42627404056,44371146946.0,169727413.0,
20120802,43560657150,1272423989,1185279719.0,87144270.0,892253942,109964795,102298268,80077757.0,22220511.0,44452911092,42668403208,41714286820.0,101432391.0,
20120803,43644324473,1253402074,1169734751.0,83667323.0,792848081,86148802,81031202,104847195.0,-23815993.0,44437172554,42851476392,43589559032.0,172394943.0,
20120806,43983961626,2086998476,1747361323.0,339637153.0,803767457,82371958,99916973,103693817.0,-3776844.0,44787729083,43180194169,60973949941.0,202645458.0,
20120807,44381161170,1916815976,1519616432.0,397199544.0,793858759,76336687,70258344,76293615.0,-6035271.0,45175019929,43587302411,61897803998.0,134853910.0,
20120808,44382355250,1651113021,1649918941.0,1194080.0,811850790,81257626,82835499,77914560.0,4920939.0,45194206040,43570504460,62235503437.0,106649949.0,
20120809,44655608409,2042616121,1769362962.0,273253159.0,807873776,80495045,96060855,96823436.0,-762581.0,45463482185,43847734633,65688409005.0,105129218.0,
20120810,44448470277,1847683090,2054821222.0,-207138132.0,775172979,74348094,80525607,86672558.0,-6146951.0,45223643256,43673297298,60858695973.0,147633885.0,
20120813,44805453973,2193592532,1836608836.0,356983696.0,723520744,72005866,104164010,106506238.0,-2342228.0,45528974717,44081933229,62980865748.0,137703326.0,
20120814,45090974216,2023420057,1737899814.0,285520243.0,705610508,72206532,97420910,97220244.0,200666.0,45796584724,44385363708,59661409263.0,140641360.0,
20120815,45370226843,1603184447,1323931820.0,279252627.0,723991809,72983227,62266955,61490260.0,776695.0,46094218652,44646235034,45904486358.0,133019149.0,
20120816,45507584487,1199331627,1061973983.0,137357644.0,704216605,69900322,54400821,57483726.0,-3082905.0,46211801092,44803367882,38976645409.0,60901230.0,
20120817,45527705227,1327191696,1307070956.0,20120740.0,676251541,69860551,71407936,71447707.0,-39771.0,46203956768,44851453686,39109126046.0,86256562.0,
20120820,45688473487,1336773539,1176005279.0,160768260.0,687917590,70237773,79200693,78823471.0,377222.0,46376391077,45000555897,39180956321.0,80960238.0,
20120821,45866054150,1670213257,1492632594.0,177580663.0,714370674,78030044,98054641,90262370.0,7792271.0,46580424824,45151683476,51485491250.0,102861648.0,
20120822,46048682213,1477904628,1295276565.0,182628063.0,712808353,75302638,73249776,75977182.0,-2727406.0,46761490566,45335873860,48912270397.0,97299537.0,
20120823,46197832033,1650535999,1501386179.0,149149820.0,741581199,84030054,122034356,113306940.0,8727416.0,46939413232,45456250834,50271096336.0,98536379.0,
20120824,45979785983,1394092725,1612138775.0,-218046050.0,739252012,74545452,91369039,100853641.0,-9484602.0,46719037995,45240533971,49563757598.0,109915417.0,
20120827,45733961176,1623650005,1869474812.0,-245824807.0,752748959,84369278,109171038,99347212.0,9823826.0,46486710135,44981212217,47763212055.0,103330891.0,
20120828,45822985926,1503902531,1414877781.0,89024750.0,806676314,101984574,147566751,129951455.0,17615296.0,46629662240,45016309612,42054329744.0,108779300.0,
20120829,45764570771,1325562119,1383977274.0,-58415155.0,774751600,90901611,98202234,109285197.0,-11082963.0,46539322371,44989819171,41589181884.0,110119195.0,
20120830,45665093836,1463049036,1562525971.0,-99476935.0,740696134,87744523,129610280,132767368.0,-3157088.0,46405789970,44924397702,50763459964.0,106554293.0,
20120831,45671816226,1075961489,1069239099.0,6722390.0,747149759,84120906,94804097,98427714.0,-3623617.0,46418965985,44924666467,35202543753.0,88414176.0,
20120903,45954941545,1669079983,1385954664.0,283125319.0,816603315,90823674,110289744,103586976.0,6702768.0,46771544860,45138338230,47868144372.0,99086062.0,
20120904,46165761015,1753553472,1542734002.0,210819470.0,825213972,91707302,136972961,136089333.0,883628.0,46990974987,45340547043,47513826338.0,74298589.0,
20120905,46434490498,1632564950,1363835467.0,268729483.0,866941167,94487151,125504126,122724277.0,2779849.0,47301431665,45567549331,44877599727.0,115326825.0,
20120906,46734326953,1608727913,1308891458.0,299836455.0,878206655,101604157,135899804,128782798.0,7117006.0,47612533608,45856120298,42696281676.0,90652359.0,
20120907,46551429029,4336815591,4519713515.0,-182897924.0,899376929,126380751,227423483,202646889.0,24776594.0,47450805958,45652052100,110887647809.0,369078341.0,
20120910,47126249677,3477138749,2902318101.0,574820648.0,886484812,119591722,112440098,119229127.0,-6789029.0,48012734489,46239764865,86118231991.0,185861550.0,
20120911,47897803829,2580282922,1808728770.0,771554152.0,796149061,110300855,110351985,119642852.0,-9290867.0,48693952890,47101654768,65836547840.0,140730758.0,
20120912,48462868314,2739662949,2174598464.0,565064485.0,822985772,101052930,162310567,171558492.0,-9247925.0,49285854086,47639882542,69131484753.0,146728157.0,
20120913,48798184410,2208340317,1873024221.0,335316096.0,830509365,96817302,127242730,131478358.0,-4235628.0,49628693775,47967675045,64515404932.0,129394176.0,
20120914,48670194775,2806237438,2934227073.0,-127989635.0,837191615,98193184,157294664,155918782.0,1375882.0,49507386390,47833003160,76056279679.0,197521845.0,
20120917,49040117321,2558273294,2188350748.0,369922546.0,817905616,94791540,146148054,149549698.0,-3401644.0,49858022937,48222211705,62315674157.0,183316471.0,
20120918,49256955701,1754116814,1537278434.0,216838380.0,767029684,81366517,126572029,139997052.0,-13425023.0,50023985385,48489926017,44316884996.0,106865028.0,
20120919,49533570717,1837774603,1561159587.0,276615016.0,814641345,86657532,123927878,118636863.0,5291015.0,50348212062,48718929372,43751768953.0,93836059.0,
20120920,49793080866,2140705780,1881195631.0,259510149.0,802087336,87505734,131210692,130362490.0,848202.0,50595168202,48990993530,53863570967.0,122699652.0,
20120921,49751841324,1769209667,1810449209.0,-41239542.0,816583676,85076142,139891973,142321565.0,-2429592.0,50568425000,48935257648,47600984140.0,120043367.0,
20120924,49922439548,1719001695,1548403471.0,170598224.0,837518922,87540937,152475719,150010924.0,2464795.0,50759958470,49084920626,45529759111.0,90322178.0,
20120925,49668053926,1347716776,1602102398.0,-254385622.0,910568341,90621853,119230488,116149572.0,3080916.0,50578622267,48757485585,38416048934.0,51730443.0,
20120926,49560420336,1300488950,1408122540.0,-107633590.0,887941875,93606857,140129407,137144403.0,2985004.0,50448362211,48672478461,38963065969.0,113495426.0,
20120927,48907506409,2351994804,3004908731.0,-652913927.0,931647214,107166059,184576201,171016999.0,13559202.0,49839153623,47975859195,60223416445.0,141583937.0,
20120928,47592602099,2247164513,3562068823.0,-1314904310.0,932013450,101326842,155872499,161711716.0,-5839217.0,48524615549,46660588649,64993192551.0,127357159.0,
20121008,48264741771,2310097195,1637957523.0,672139672.0,969055748,119718461,115648046,97256427.0,18391619.0,49233797519,47295686023,45032679070.0,96628397.0,
20121009,48396852337,2764492399,2632381833.0,132110566.0,1092153231,133467259,146184953,132436155.0,13748798.0,49489005568,47304699106,67476185993.0,173687274.0,
20121010,48919543554,2279615232,1756924015.0,522691217.0,1073263343,131883103,129690882,131275038.0,-1584156.0,49992806897,47846280211,60554151818.0,120377126.0,
20121011,49440483610,2225160985,1704220929.0,520940056.0,1045817724,141203222,195813581,186493462.0,9320119.0,50486301334,48394665886,56676832124.0,100613775.0,
20121012,49448638952,1908823608,1900668266.0,8155342.0,1025770688,129877794,156486705,167812133.0,-11325428.0,50474409640,48422868264,51434188971.0,84927906.0,
20121015,49663180778,1691218706,1476676880.0,214541826.0,1090407763,142655629,113395044,100617209.0,12777835.0,50753588541,48572773015,42469763506.0,85760835.0,
20121016,49763747191,1844932312,1744365899.0,100566413.0,1125348375,147389523,159267653,154533759.0,4733894.0,50889095566,48638398816,47213998937.0,98237669.0,
20121017,50073315146,1926672446,1617104491.0,309567955.0,1172942823,156206434,153853715,145036804.0,8816911.0,51246257969,48900372323,47176964019.0,66888658.0,
20121018,49898366599,2447878705,2622827252.0,-174948547.0,1258697877,172225102,161104011,145085343.0,16018668.0,51157064476,48639668722,65808522889.0,133013776.0,
20121019,49690327417,1848948756,2056987938.0,-208039182.0,1170027001,149291084,135684548,158618566.0,-22934018.0,50860354418,48520300416,50854836344.0,86221934.0,
20121022,49878708176,1994060503,1805679744.0,188380759.0,1243452816,164809687,139669193,124150590.0,15518603.0,51122160992,48635255360,47794388581.0,79273959.0,
20121023,50268571335,2284288793,1894425634.0,389863159.0,1165651473,159591985,131752963,136970665.0,-5217702.0,51434222808,49102919862,54196541499.0,69250604.0,
20121024,50553991724,1887157124,1601736735.0,285420389.0,1157441737,154386431,133866147,139071701.0,-5205554.0,51711433461,49396549987,49735385642.0,66510231.0,
20121025,50925458666,2168295969,1796829027.0,371466942.0,1100159828,146078286,139550740,147858885.0,-8308145.0,52025618494,49825298838,55659151912.0,106072450.0,
20121026,51310726506,2288657132,1903389292.0,385267840.0,889943114,119586704,111326685,137818267.0,-26491582.0,52200669620,50420783392,54178339149.0,120212285.0,
20121029,51689038799,1584953781,1206641488.0,378312293.0,927847068,122834403,128121470,124873771.0,3247699.0,52616885867,50761191731,39479068710.0,90161667.0,
20121030,51501871483,1589603973,1776771289.0,-187167316.0,1001355314,137652090,151389572,136571885.0,14817687.0,52503226797,50500516169,42722968497.0,65440726.0,
20121031,51559113178,1692366022,1635124327.0,57241695.0,1063191973,141296023,159333903,155689970.0,3643933.0,52622305151,50495921205,43106204275.0,82242494.0,
20121101,51237157202,2617929839,2939885815.0,-321955976.0,1142165204,159064788,186500459,168731694.0,17768765.0,52379322406,50094991998,62524657779.0,174538437.0,
20121102,51130702397,2343570856,2450025661.0,-106454805.0,1181065951,163272076,147342085,143134797.0,4207288.0,52311768348,49949636446,56826908712.0,97424469.0,
20121105,51362279911,2316295635,2084718121.0,231577514.0,1218018631,165124083,143928818,142076811.0,1852007.0,52580298542,50144261280,53298133974.0,92650889.0,
20121106,51683392819,2421704753,2100591845.0,321112908.0,1180023770,159388987,166281041,172016137.0,-5735096.0,52863416589,50503369049,53751447826.0,108568582.0,
20121107,51842199361,2051691468,1892884926.0,158806542.0,1198477605,159650300,200321673,200060360.0,261313.0,53040676966,50643721756,47464148375.0,65397118.0,
20121108,51702911891,2055487490,2194774960.0,-139287470.0,1160802573,156054457,224975405,228571248.0,-3595843.0,52863714464,50542109318,49535873361.0,93586601.0,
20121109,51496481543,1478652032,1685082380.0,-206430348.0,1169277224,158011064,207705413,205748806.0,1956607.0,52665758767,50327204319,39072017275.0,71554972.0,
20121112,51537026715,1767231895,1726686723.0,40545172.0,1292540521,194274310,239937283,203674037.0,36263246.0,52829567236,50244486194,42434694751.0,56333359.0,
20121113,51621569073,1885583091,1801040733.0,84542358.0,1282131180,190958378,216004448,219320380.0,-3315932.0,52903700253,50339437893,44573008683.0,91706674.0,
20121114,51742932659,1519967699,1398604113.0,121363586.0,1331110919,193814073,272000019,269144324.0,2855695.0,53074043578,50411821740,35957747085.0,68948644.0,
20121115,51834437830,1585328945,1493823774.0,91505171.0,1291515135,181548847,229951784,242217010.0,-12265226.0,53125952965,50542922695,37159976723.0,49206992.0,
20121116,51842436713,1662234177,1654235294.0,7998883.0,1175452798,164870960,239594991,256272878.0,-16677887.0,53017889511,50666983915,36751048993.0,74963727.0,
20121119,52136377757,1674655573,1380714529.0,293941044.0,1227615384,166061919,252906374,251715415.0,1190959.0,53363993141,50908762373,36049599418.0,54080782.0,
20121120,52232906651,1509399872,1412870978.0,96528894.0,1208322014,166143592,225334923,225253250.0,81673.0,53441228665,51024584637,33387337186.0,55186362.0,
20121121,52338359165,1943146103,1837693589.0,105452514.0,1306569346,184856026,308581665,289869231.0,18712434.0,53644928511,51031789819,40066614466.0,59202214.0,
20121122,52326315202,1332145449,1344189412.0,-12043963.0,1302639373,172773106,214932697,227015617.0,-12082920.0,53628954575,51023675829,33996785861.0,28585981.0,
20121123,52163842479,1543727769,1706200492.0,-162472723.0,1347840020,184949966,257859771,245682911.0,12176860.0,53511682499,50816002459,38873221931.0,54956908.0,
20121126,52224867623,1322180521,1261155377.0,61025144.0,1366826765,187498079,234474541,231926428.0,2548113.0,53591694388,50858040858,33083128385.0,46793651.0,
20121127,52059352556,1561381214,1726896281.0,-165515067.0,1384086520,195318232,255616186,247796033.0,7820153.0,53443439076,50675266036,39050258393.0,62775227.0,
20121128,51839015969,1430771351,1651107938.0,-220336587.0,1363891223,200577797,252283104,247023539.0,5259565.0,53202907192,50475124746,34549454760.0,84834129.0,
20121129,51590830813,1428621103,1676806259.0,-248185156.0,1487427984,216979129,274952139,258550807.0,16401332.0,53078258797,50103402829,33186340178.0,68030754.0,
20121130,51380781508,1715103966,1925153271.0,-210049305.0,1534954623,213227459,272225784,275977454.0,-3751670.0,52915736131,49845826885,37646123983.0,178074564.0,
20121203,50979389957,1746129421,2147520972.0,-401391551.0,1642665995,231641500,230229452,211815411.0,18414041.0,52622055952,49336723962,43045528609.0,93878957.0,
20121204,50719310027,1668156873,1928236803.0,-260079930.0,1691394679,247998486,210297671,193940685.0,16356986.0,52410704706,49027915348,43408118587.0,98633209.0,
20121205,50824143024,4221718658,4116885661.0,104832997.0,1791669857,260754780,342048073,329291779.0,12756294.0,52615812881,49032473167,85699288622.0,244169879.0,
20121206,51239355809,2710160062,2294947277.0,415212785.0,1773461775,245045308,274816420,290525892.0,-15709472.0,53012817584,49465894034,58865727306.0,90117651.0,
20121207,51153092419,3742788183,3829051573.0,-86263390.0,1908057633,273389625,308254110,279909793.0,28344317.0,53061150052,49245034786,82508551626.0,159583299.0,
20121210,51306934372,3401162233,3247320280.0,153841953.0,2052661137,313129159,312883081,273143547.0,39739534.0,53359595509,49254273235,81350096968.0,156918160.0,
20121211,51868905998,3125289600,2563317974.0,561971626.0,2031576319,306225400,265454958,272358717.0,-6903759.0,53900482317,49837329679,68014145218.0,114509518.0,
20121212,52377520737,2687398378,2178783639.0,508614739.0,2098295346,317828422,267006109,255403087.0,11603022.0,54475816083,50279225391,57147049057.0,92424763.0,
20121213,52669288553,2246499161,1954731345.0,291767816.0,1953468786,288677886,217352599,246503135.0,-29150536.0,54622757339,50715819767,52640824137.0,128901605.0,
20121214,52791881649,5843342497,5720749401.0,122593096.0,2087408295,307018627,328393870,310053129.0,18340741.0,54879289944,50704473354,118041381430.0,295519915.0,
20121217,53571995017,5541610549,4761497181.0,780113368.0,2198213076,330016054,294180919,271183492.0,22997427.0,55770208093,51373781941,110744340879.0,222285595.0,
20121218,54408074635,5151252842,4315173224.0,836079618.0,2270274901,337189498,300649942,293476498.0,7173444.0,56678349536,52137799734,99293833763.0,210297526.0,
20121219,54931071842,3768910786,3245913579.0,522997207.0,2273481726,349579396,230855261,218465363.0,12389898.0,57204553568,52657590116,76128305755.0,127331981.0,
20121220,55689600270,4484712392,3726183964.0,758528428.0,2242931415,326438956,345922585,369063025.0,-23140440.0,57932531685,53446668855,80689366423.0,119113343.0,
20121221,56447787112,4689255807,3931068965.0,758186842.0,2139542755,307394734,269920339,288964561.0,-19044222.0,58587329867,54308244357,84652534186.0,195721371.0,
20121224,57128889679,3788187865,3107085298.0,681102567.0,2257004885,333460818,296162726,270096642.0,26066084.0,59385894564,54871884794,68046671449.0,140536205.0,
20121225,57544359600,6368458672,5952988751.0,415469921.0,2456222039,388333500,409792961,354920279.0,54872682.0,60000581639,55088137561,115577204281.0,275111681.0,
20121226,58354981334,5114111979,4303490245.0,810621734.0,2417109460,376278216,234225185,246280469.0,-12055284.0,60772090794,55937871874,97211061248.0,399060538.0,
20121227,59152544022,5373168743,4575606055.0,797562688.0,2353661865,361640747,331518088,346155557.0,-14637469.0,61506205887,56798882157,100286562849.0,347381317.0,
20121228,59294670143,5297737080,5155610959.0,142126121.0,2460898300,386182354,384019735,359478128.0,24541607.0,61755568443,56833771843,91978171320.0,435722679.0,
20121231,59014161465,5633864416,5914373094.0,-280508678.0,2751605671,490805859,407517940,302894435.0,104623505.0,61765767136,56262555794,105492768120.0,347324220.0,
20130104,60785480318,7407752903,5636434050.0,1771318853.0,2811995346,468316259,249165702,271655302.0,-22489600.0,63597475664,57973484972,114215662697.0,548601635.0,
20130107,62235629990,5443529030,3993379358.0,1450149672.0,2933725931,496273481,275217920,247260698.0,27957222.0,65169355921,59301904059,96590512647.0,640647485.0,
20130108,63304834290,5640074918,4570870618.0,1069204300.0,2760964424,470222324,228406328,254457485.0,-26051157.0,66065798714,60543869866,105613758724.0,903581271.0,
20130109,64195114532,5722165174,4831884932.0,890280242.0,2728892539,473092376,259417409,256547357.0,2870052.0,66924007071,61466221993,102482319155.0,577963533.0,
20130110,65288113087,5763183125,4670184570.0,1092998555.0,2812446464,482789420,252995418,243298374.0,9697044.0,68100559551,62475666623,98278284296.0,401048139.0,
20130111,65761864960,5721944752,5248192879.0,473751873.0,2503842541,428139149,229860202,284510473.0,-54650271.0,68265707501,63258022419,101384041449.0,422960405.0,
20130114,66993937995,7911830846,6679757811.0,1232073035.0,2776368938,450430887,324599804,302308066.0,22291738.0,69770306933,64217569057,123763541176.0,485031918.0,
20130115,68086057649,7691869725,6599750071.0,1092119654.0,2866456375,462407649,269803585,257826823.0,11976762.0,70952514024,65219601274,140957870631.0,412349890.0,
20130116,69257047349,7447346465,6276356765.0,1170989700.0,2712346680,427966270,234712367,269153746.0,-34441379.0,71969394029,66544700669,133648417284.0,372281840.0,
20130117,70577250953,5886935810,4566732206.0,1320203604.0,2549583418,401297868,260767601,287436003.0,-26668402.0,73126834371,68027667535,102983613740.0,350370292.0,
20130118,70367079826,5755908405,5966079532.0,-210171127.0,2715427584,422240885,284914625,263971608.0,20943017.0,73082507410,67651652242,105732527712.0,367734635.0,
20130121,71876409211,6561602308,5052272923.0,1509329385.0,2889135338,467597658,280265354,234908581.0,45356773.0,74765544549,68987273873,112687719852.0,675224757.0,
20130122,73300956177,7837765200,6413218234.0,1424546966.0,2877985819,484012406,383004646,366589898.0,16414748.0,76178941996,70422970358,122537720204.0,894433373.0,
20130123,74367360145,5642831418,4576427450.0,1066403968.0,2824296289,452815961,266353151,297549596.0,-31196445.0,77191656434,71543063856,96329322910.0,699764013.0,
20130124,74826755422,8055560610,7596165333.0,459395277.0,2769072963,443965934,363638399,372488426.0,-8850027.0,77595828385,72057682459,135648430324.0,787742037.0,
20130125,74656422784,3835370531,4005703169.0,-170332638.0,2643745664,409112298,213678710,248532346.0,-34853636.0,77300168448,72012677120,80087282930.0,453404460.0,
20130128,75824006707,7217230263,6049646340.0,1167583923.0,3070041858,488530667,342789657,263371288.0,79418369.0,78894048565,72753964849,116856319992.0,492817752.0,
20130129,77370649389,8032156123,6485513441.0,1546642682.0,3195250984,524521539,324575148,288584276.0,35990872.0,80565900373,74175398405,124779227849.0,483959151.0,
20130130,79109519537,8022477919,6283607771.0,1738870148.0,3231189179,542739932,300927152,282708759.0,18218393.0,82340708716,75878330358,124561883314.0,368821878.0,
20130131,80012584798,7429868873,6526803612.0,903065261.0,3229530293,533770933,246998316,255967315.0,-8968999.0,83242115091,76783054505,116096078985.0,463129677.0,
20130201,79974275475,7920561619,7958870942.0,-38309323.0,3294340997,520978774,285848430,298640589.0,-12792159.0,83268616472,76679934478,125202764645.0,499819768.0,
20130204,82305911782,11251626666,8919990359.0,2331636307.0,3224025811,508919726,314655291,326714339.0,-12059048.0,85529937593,79081885971,152155264207.0,541290120.0,
20130205,83842570892,9474416050,7937756940.0,1536659110.0,3132341883,470151254,284032107,322800579.0,-38768472.0,86974912775,80710229009,127043896954.0,419482361.0,
20130206,85266773477,7874045216,6449842631.0,1424202585.0,3110879179,455924139,206983997,221211112.0,-14227115.0,88377652656,82155894298,104486643229.0,507256886.0,
20130207,86663004886,8580920767,7184689358.0,1396231409.0,2660619696,366210902,211824227,301537464.0,-89713237.0,89323624582,84002385190,108925452962.0,617134079.0,
20130208,84932368202,6812942439,8543579123.0,-1730636684.0,2418021962,329320025,172759587,209650464.0,-36890877.0,87350390164,82514346240,98350930312.0,624659390.0,
20130218,87926525532,8842693426,5848536096.0,2994157330.0,2416617093,335820575,205111168,198610618.0,6500550.0,90343142625,85509908439,103318583673.0,440166414.0,
20130219,89876334442,7886100852,5936291942.0,1949808910.0,2271718764,313654098,213396088,235562565.0,-22166477.0,92148053206,87604615678,105519282173.0,886138813.0,
20130220,90333744696,6361224934,5903814680.0,457410254.0,2257186074,302836704,223244382,234061776.0,-10817394.0,92590930770,88076558622,96998567510.0,397822943.0,
20130221,91468231688,8401141942,7266654950.0,1134486992.0,1853586564,249389678,262302413,315749439.0,-53447026.0,93321818252,89614645124,126091483430.0,591088292.0,
20130222,91592282645,5317827763,5193776806.0,124050957.0,1742091491,230803646,210726317,229312349.0,-18586032.0,93334374136,89850191154,87159897375.0,423243610.0,
20130225,92421928218,4784968168,3955322595.0,829645573.0,1830456434,251500918,232553313,211856041.0,20697272.0,94252384652,90591471784,77925824968.0,318154161.0,
20130226,94033826662,7658469765,6046571321.0,1611898444.0,1805074779,239348529,286012204,298164593.0,-12152389.0,95838901441,92228751883,106038910151.0,468049377.0,
20130227,94762628748,5775746098,5046944012.0,728802086.0,1840023561,259018993,317130058,297459594.0,19670464.0,96602652309,92922605187,89074731894.0,340901751.0,
20130228,94814148222,7990991763,7939472289.0,51519474.0,2105272544,286756914,353484188,325746267.0,27737921.0,96919420766,92708875678,116018651562.0,484836919.0,
20130301,95606134303,7320602629,6528616548.0,791986081.0,1972673189,262116842,263260807,287900879.0,-24640072.0,97578807492,93633461114,111127556643.0,419902993.0,
20130304,97426076304,9066487513,7246545512.0,1819942001.0,1727135393,232683604,308220189,337653427.0,-29433238.0,99153211697,95698940911,142683723301.0,506538925.0,
20130305,98534885455,8155054783,7046245632.0,1108809151.0,2000673735,279817534,402108670,354974740.0,47133930.0,100535559190,96534211720,117116914972.0,316127144.0,
20130306,99945597555,8520559834,7109847734.0,1410712100.0,2115377147,299587767,327014420,307244187.0,19770233.0,102060974702,97830220408,125060337106.0,494139254.0,
20130307,101488438654,8464044001,6921202902.0,1542841099.0,1966923628,274465533,309917753,335039987.0,-25122234.0,103455362282,99521515026,125822916546.0,387226241.0,
20130308,101901925034,5936313125,5522826745.0,413486380.0,1987526048,275907117,290445126,289003542.0,1441584.0,103889451082,99914398986,88528901201.0,310411503.0,
20130311,102821772759,5082088791,4162241066.0,919847725.0,1948452838,267982074,276632787,284557830.0,-7925043.0,104770225597,100873319921,73957507008.0,229567074.0,
20130312,102711768682,7022483678,7132487755.0,-110004077.0,1902714770,262582542,314762594,320162126.0,-5399532.0,104614483452,100809053912,100605403105.0,410246162.0,
20130313,104108557626,5513877779,4117088835.0,1396788944.0,1825837512,254251612,299097407,307428337.0,-8330930.0,105934395138,102282720114,77517212235.0,250025069.0,
20130314,104874569425,4609782978,3843771179.0,766011799.0,1996905584,286117015,283442449,251577046.0,31865403.0,106871475009,102877663841,70391777491.0,204277746.0,
20130315,105626987105,7471161896,6718744216.0,752417680.0,2011775416,288992367,408902401,406027049.0,2875352.0,107638762521,103615211689,101418330262.0,321847061.0,
20130318,106238513278,5282720607,4671194434.0,611526173.0,2019528889,276039932,267797480,280749915.0,-12952435.0,108258042167,104218984389,81304217544.0,195709020.0,
20130319,106755434421,5201097686,4684176543.0,516921143.0,2130073796,291718070,289261107,273582969.0,15678138.0,108885508217,104625360625,75448274989.0,199943670.0,
20130320,107196193138,8066187351,7625428634.0,440758717.0,2399762325,331895869,415504328,375326529.0,40177799.0,109595955463,104796430813,113792303122.0,300969868.0,
20130321,108019003348,7062886655,6240076445.0,822810210.0,2483731778,334857043,270158014,267196840.0,2961174.0,110502735126,105535271570,104686809067.0,277454715.0,
20130322,108591092977,5511652970,4939563341.0,572089629.0,2435871005,318449443,243690346,260097946.0,-16407600.0,111026963982,106155221972,85946767801.0,190357720.0,
20130325,109877567428,6297772712,5011298261.0,1286474451.0,2449059912,316957896,279004940,280496487.0,-1491547.0,112326627340,107428507516,85542133772.0,180825078.0,
20130326,111035476296,7099634360,5941725492.0,1157908868.0,2248488085,294171941,266674030,289459985.0,-22785955.0,113283964381,108786988211,91618901867.0,503938443.0,
20130327,112137310840,6298683390,5196848846.0,1101834544.0,2269197193,291761330,267285479,269696090.0,-2410611.0,114406508033,109868113647,85609433706.0,202726859.0,
20130328,113187084739,8010031524,6960257625.0,1049773899.0,1899979450,241346363,325060876,375475843.0,-50414967.0,115087064189,111287105289,107350476749.0,246179770.0,
20130329,112888053998,5204018492,5503049233.0,-299030741.0,1883391009,235085790,287753194,294013767.0,-6260573.0,114771445007,111004662989,73381920123.0,157467807.0,
20130401,113635641259,4542232360,3794645099.0,747587261.0,1823593206,236893360,232219448,230411878.0,1807570.0,115459234465,111812048053,66955959838.0,98752909.0,
20130402,114124843819,5298058935,4808856375.0,489202560.0,1812584900,233982688,288122642,291033314.0,-2910672.0,115937428719,112312258919,77504473326.0,165573509.0,
20130403,113947874189,4074983283,4251952913.0,-176969630.0,1829121676,238181467,269389114,265190335.0,4198779.0,115776995865,112118752513,68578908576.0,233038512.0,
20130408,115054289211,4894186965,3787771943.0,1106415022.0,1762793624,231800180,298927793,305309080.0,-6381287.0,116817082835,113291495587,73592991654.0,209178334.0,
20130409,115626276701,4952528226,4380540736.0,571987490.0,1985863434,281641041,320378225,270537364.0,49840861.0,117612140135,113640413267,73172380222.0,211096560.0,
20130410,115776352843,4753020947,4602944805.0,150076142.0,2142951912,312303383,288025234,257362892.0,30662342.0,117919304755,113633400931,71564904601.0,177853017.0,
20130411,116103113411,4192362486,3865601918.0,326760568.0,2152973603,316677057,201267777,196894103.0,4373674.0,118256087014,113950139808,62352063769.0,138706387.0,
20130412,115950047834,3905815812,4058881389.0,-153065577.0,2148492748,303698649,213041967,226020375.0,-12978408.0,118098540582,113801555086,56646140055.0,156191467.0,
20130415,116037778763,4245116922,4157385993.0,87730929.0,2199324054,310449750,266042893,259291792.0,6751101.0,118237102817,113838454709,58239668307.0,306975146.0,
20130416,116263244718,5209405509,4983939554.0,225465955.0,2139946274,296228182,307886724,322108292.0,-14221568.0,118403190992,114123298444,66930533855.0,222656532.0,
20130417,117144800742,4875309857,3993753833.0,881556024.0,2267620822,327887516,391843539,360184205.0,31659334.0,119412421564,114877179920,60139454128.0,180502778.0,
20130418,117671674605,4771936720,4245062857.0,526873863.0,2292643432,329887400,295537900,293538016.0,1999884.0,119964318037,115379031173,61759506274.0,147183038.0,
20130419,117698737075,7739024920,7711962450.0,27062470.0,2443084447,352285862,412698424,390299962.0,22398462.0,120141821522,115255652628,95171939178.0,330257452.0,
20130422,119391719252,7099827303,5406845126.0,1692982177.0,2384691901,321564829,219729253,250450286.0,-30721033.0,121776411153,117007027351,82075897733.0,214950478.0,
20130423,120768319189,7082174321,5705574384.0,1376599937.0,2131780731,276912714,257901753,302553868.0,-44652115.0,122900099920,118636538458,81977846882.0,248700626.0,
20130424,121552670270,6827152161,6042801080.0,784351081.0,2287185309,301987832,379207719,354132601.0,25075118.0,123839855579,119265484961,78851250808.0,204496917.0,
20130425,122009589488,6886959934,6430040716.0,456919218.0,2172998614,281114391,336901479,357774920.0,-20873441.0,124182588102,119836590874,84283336789.0,277753055.0,
20130426,121166321228,5086048547,5929316807.0,-843268260.0,1942209657,231242790,231262387,281133988.0,-49871601.0,123108530885,119224111571,65022429480.0,339573642.0,
20130502,122197863473,5644481042,4612938797.0,1031542245.0,2057674882,256379935,262890394,237753249.0,25137145.0,124255538355,120140188591,59685207371.0,244577562.0,
20130503,121887004198,6620964102,6931823377.0,-310859275.0,2148735200,273711623,352356561,335024873.0,17331688.0,124035739398,119738268998,79731656670.0,287035337.0,
20130506,123361128607,7268197122,5794072713.0,1474124409.0,2276921533,308417317,339490889,304785195.0,34705694.0,125638050140,121084207074,82409761494.0,286754316.0,
20130507,124270338683,7074720877,6165510801.0,909210076.0,2362140752,329810628,303058394,281665083.0,21393311.0,126632479435,121908197931,79682889201.0,208334675.0,
20130508,124888103709,7157542145,6539777119.0,617765026.0,2507217737,361546449,301418246,269682425.0,31735821.0,127395321446,122380885972,81766163840.0,237442263.0,
20130509,126419196551,8168053782,6636960940.0,1531092842.0,2374710357,328586084,252690084,285650449.0,-32960365.0,128793906908,124044486194,91508672446.0,178512353.0,
20130510,126740444825,6034576415,5713328141.0,321248274.0,2303727340,302954623,290496190,316127651.0,-25631461.0,129044172165,124436717485,81347568938.0,270953737.0,
20130513,128164330004,6459752621,5035867442.0,1423885179.0,2360915033,311975510,275974650,266953763.0,9020887.0,130525245037,125803414971,79041634138.0,187052287.0,
20130514,129517780377,6593084766,5239634393.0,1353450373.0,2337690202,311169908,246497726,247303328.0,-805602.0,131855470579,127180090175,75576860553.0,201678439.0,
20130515,130323971618,5529182884,4722991643.0,806191241.0,2433053208,337709979,254134124,227594053.0,26540071.0,132757024826,127890918410,66707590290.0,138608329.0,
20130516,131622975578,8878686659,7579682699.0,1299003960.0,2475366123,355984760,395813111,377538330.0,18274781.0,134098341701,129147609455,102182691281.0,291340794.0,
20130517,131417103569,8768077046,8973949055.0,-205872009.0,2470385623,356603362,395353262,394734660.0,618602.0,133887489192,128946717946,111146350195.0,303012352.0,
20130520,133091760357,11095254875,9420598087.0,1674656788.0,2517281991,346464716,375552639,385691285.0,-10138646.0,135609042348,130574478366,129041797252.0,380983764.0,
20130521,134817899289,9591121306,7864982374.0,1726138932.0,2334850741,314915983,267288382,298837115.0,-31548733.0,137152750030,132483048548,113568904977.0,246881190.0,
20130522,136139858373,9552038138,8230079054.0,1321959084.0,2437489139,324325489,260782720,251373214.0,9409506.0,138577347512,133702369234,115469566215.0,280675400.0,
20130523,138316858947,10511455801,8334455227.0,2177000574.0,2344207599,310549981,314530094,328305602.0,-13775508.0,140661066546,135972651348,111427266589.0,247285595.0,
20130524,138984769078,7928041003,7260130872.0,667910131.0,2234197713,288295711,251500832,273755102.0,-22254270.0,141218966791,136750571365,91915443169.0,195594815.0,
20130527,140820346371,9894922165,8059344872.0,1835577293.0,2305293833,302399486,286551661,272447886.0,14103775.0,143125640204,138515052538,99771595060.0,217713692.0,
20130528,141777400469,11214809176,10257755078.0,957054098.0,2455374710,327865545,457461210,431995151.0,25466059.0,144232775179,139322025759,120698065895.0,235978348.0,
20130529,143149532749,11029505099,9657372819.0,1372132280.0,2456234080,318752046,416142975,425256474.0,-9113499.0,145605766829,140693298669,114725878646.0,210589255.0,
20130530,144688843185,10070309550,8530999114.0,1539310436.0,2418228409,307986096,339229593,349995543.0,-10765950.0,147107071594,142270614776,103626514680.0,218650166.0,
20130531,145252249948,9369266328,8805859565.0,563406763.0,2258880000,283827772,359663134,383821458.0,-24158324.0,147511129948,142993369948,100437015797.0,455267006.0,
20130603,147120806309,8694878633,6826322272.0,1868556361.0,2557650932,345692219,301121296,239256849.0,61864447.0,149678457241,144563155377,91479741008.0,275194937.0,
20130604,148442795180,8363093077,7041104206.0,1321988871.0,2171821367,259566015,335833052,421959256.0,-86126204.0,150614616547,146270973813,92169142355.0,274537197.0,
20130605,148965564717,6605148405,6082378868.0,522769537.0,2183048019,249272537,237057925,247351403.0,-10293478.0,151148612736,146782516698,71024479986.0,258194288.0,
20130606,149151822571,7577268832,7391010978.0,186257854.0,2071556115,233869034,242293234,257696737.0,-15403503.0,151223378686,147080266456,75191741067.0,170355951.0,
20130607,148108787978,7526886429,8569921022.0,-1043034593.0,1957883747,215926657,235243875,253186252.0,-17942377.0,150066671725,146150904231,81249856843.0,220878462.0,
20130613,149005277420,7009864137,6113374695.0,896489442.0,1993164182,236661204,332491436,311756889.0,20734547.0,150998441602,147012113238,79901473026.0,277266884.0,
20130614,148836812594,5797043147,5965507973.0,-168464826.0,2061640842,265154999,374802575,346308780.0,28493795.0,150898453436,146775171752,68824703762.0,153988669.0,
20130617,150422821027,6939993912,5353985479.0,1586008433.0,2128562400,266931758,428371823,426595064.0,1776759.0,152551383427,148294258627,68563890891.0,130870817.0,
20130618,151212539265,5884392397,5094674159.0,789718238.0,2230422477,301010932,477439795,443360621.0,34079174.0,153442961742,148982116788,63533751478.0,115137743.0,
20130619,152169383198,6713609038,5756765105.0,956843933.0,2207794093,332495342,492808671,461324261.0,31484410.0,154377177291,149961589105,67053281651.0,131587696.0,
20130620,152880634081,6490612227,5779361344.0,711250883.0,1987313226,267805604,373385951,438075689.0,-64689738.0,154867947307,150893320855,68091781730.0,191901360.0,
20130621,152615187662,5782677649,6048124068.0,-265446419.0,1965173140,239939372,486182674,514048906.0,-27866232.0,154580360802,150650014522,67336697065.0,214560221.0,
20130624,150897063226,7735165100,9453289536.0,-1718124436.0,1790650183,241094775,569964484,568809081.0,1155403.0,152687713409,149106413043,87720503469.0,259264241.0,
20130625,147919911357,8118020855,11095172724.0,-2977151869.0,1778591939,284873562,719022421,675243634.0,43778787.0,149698503296,146141319418,104508667505.0,327836212.0,
20130626,148060353548,6758398626,6617956435.0,140442191.0,1947125975,324544187,593516269,553845644.0,39670625.0,150007479523,146113227573,80706721587.0,208374162.0,
20130627,146817016731,6272155736,7515492553.0,-1243336817.0,2249592302,407714571,571116427,487946043.0,83170384.0,149066609033,144567424429,84206741428.0,205555873.0,
20130628,145646592122,6216909816,7387334425.0,-1170424609.0,2530272294,473465671,503128004,437376904.0,65751100.0,148176864416,143116319828,77478620709.0,183242748.0,
20130701,145470354637,4848225334,5024462819.0,-176237485.0,2788908395,554047588,406632907,326050990.0,80581917.0,148259263032,142681446242,63166934063.0,124452851.0,
20130702,145793434860,6140202318,5817122095.0,323080223.0,2994913148,604798583,363271927,312520932.0,50750995.0,148788348008,142798521712,74047260421.0,123404628.0,
20130703,146331396911,6458798024,5920835973.0,537962051.0,3122156208,666149816,392375429,331024196.0,61351233.0,149453553119,143209240703,76720114462.0,144978913.0,
20130704,146431475969,6940758376,6840679318.0,100079058.0,3222892968,705957074,363351094,323543836.0,39807258.0,149654368937,143208583001,82631834069.0,166241790.0,
20130705,146113979021,6311258009,6628754957.0,-317496948.0,3346427225,746417774,295951637,255490937.0,40460700.0,149460406246,142767551796,75044336129.0,119539396.0,
20130708,145461882454,5161294561,5813391128.0,-652096567.0,3349007814,765919918,290271717,270769573.0,19502144.0,148810890268,142112874640,67103652925.0,133254130.0,
20130709,145223927180,4060138518,4298093792.0,-237955274.0,3406756562,776212943,280443999,270150974.0,10293025.0,148630683742,141817170618,52218231181.0,96439524.0,
20130710,145468426190,6516616406,6272117396.0,244499010.0,3459103698,788853066,321720518,309080395.0,12640123.0,148927529888,142009322492,72769335354.0,168512136.0,
20130711,144993447524,11836354163,12311332829.0,-474978666.0,3534498235,724533627,405142193,469461632.0,-64319439.0,148527945759,141458949289,130877640659.0,297865677.0,
20130712,145732591370,10184240097,9445096251.0,739143846.0,3012711389,543415311,313147034,494265350.0,-181118316.0,148745302759,142719879981,103011828999.0,205992227.0,
20130715,146480487307,8714916690,7967020753.0,747895937.0,3162192097,545894285,393604878,391125904.0,2478974.0,149642679404,143318295210,87857395855.0,171208405.0,
20130716,147690127651,7899410046,6689769702.0,1209640344.0,3279213977,603789521,404277328,346382092.0,57895236.0,150969341628,144410913674,82877357342.0,130948216.0,
20130717,147809024524,7738122870,7619225997.0,118896873.0,3120392198,554605991,362363182,411546712.0,-49183530.0,150929416722,144688632326,88090175348.0,137867755.0,
20130718,148720424372,6705464503,5794064655.0,911399848.0,2904179326,502715126,329896451,381787316.0,-51890865.0,151624603698,145816245046,76730195736.0,87852328.0,
20130719,147876128209,7248688103,8092984266.0,-844296163.0,2796392120,502247173,446867647,447335600.0,-467953.0,150672520329,145079736089,87513514813.0,121155157.0,
20130722,148324934682,5694020549,5245214076.0,448806473.0,2872246439,516275709,407632288,393603752.0,14028536.0,151197181121,145452688243,69656896631.0,123612782.0,
20130723,148858609892,8486417073,7952741863.0,533675210.0,3001644404,528495519,465502092,453282282.0,12219810.0,151860254296,145856965488,93069519827.0,142737533.0,
20130724,149279195818,8617463762,8196877836.0,420585926.0,2930065483,554078145,443661952,418079326.0,25582626.0,152209261301,146349130335,93751526544.0,109606910.0,
20130725,149232789418,7665729318,7712135718.0,-46406400.0,3040026973,579938408,365801524,339941261.0,25860263.0,152272816391,146192762445,86206402798.0,105659327.0,
20130726,148875607683,5432377690,5789559425.0,-357181735.0,3020509405,584027672,272334242,268244978.0,4089264.0,151896117088,145855098278,65551059130.0,72471462.0,
20130729,149188477758,6003177022,5690306947.0,312870075.0,3146310551,660636545,364563120,287954247.0,76608873.0,152334788309,146042167207,65925087487.0,73284084.0,
20130730,149207743996,6003056011,5983789773.0,19266238.0,3192347775,668748160,354839138,346727523.0,8111615.0,152400091771,146015396221,66395361187.0,95329997.0,
20130731,149420127021,5473314564,5260931539.0,212383025.0,3310731997,688141829,317514868,298121199.0,19393669.0,152730859018,146109395024,59372561863.0,96075309.0,
20130801,149555722683,7121569170,6985973508.0,135595662.0,3337528664,669954254,354785014,372972589.0,-18187575.0,152893251347,146218194019,77299220442.0,144670963.0,
20130802,148969271079,7328513424,7914965028.0,-586451604.0,3167904972,571196826,244524797,343282225.0,-98757428.0,152137176051,145801366107,78717648673.0,230903408.0,
20130805,149397053080,7193323164,6765541163.0,427782001.0,3258698825,562127595,267773693,276842924.0,-9069231.0,152655751905,146138354255,73333035080.0,186791004.0,
20130806,149657184867,8542220553,8282088766.0,260131787.0,3207775784,560754251,341131891,342505235.0,-1373344.0,152864960651,146449409083,88997224174.0,187487050.0,
20130807,150260238669,8933967401,8330913599.0,603053802.0,3248447266,562354436,353901159,352300974.0,1600185.0,153508685935,147011791403,91229202609.0,152523857.0,
20130808,151421916796,7147549342,5985871215.0,1161678127.0,3184371304,551215343,302562314,313701407.0,-11139093.0,154606288100,148237545492,71949564070.0,111486703.0,
20130809,151564666504,7775889605,7633139897.0,142749708.0,3131592635,532873753,322595309,340936899.0,-18341590.0,154696259139,148433073869,82939633781.0,141617879.0,
20130812,151556419573,10517806898,10526053829.0,-8246931.0,3289803971,534690876,422254784,420437661.0,1817123.0,154846223544,148266615602,116277998105.0,253516085.0,
20130813,152674633346,9467806071,8349592298.0,1118213773.0,3213818900,516575565,312581246,330696557.0,-18115311.0,155888452246,149460814446,96261957130.0,183564947.0,
20130814,152811481913,9089551977,8952703410.0,136848567.0,3191811966,511343014,354927551,360160102.0,-5232551.0,156003293879,149619669947,96018813708.0,244285298.0,
20130815,153382068990,7899681215,7329094138.0,570587077.0,3054873234,483929193,296980699,324394520.0,-27413821.0,156436942224,150327195756,84667896227.0,194056466.0,
20130816,154515208872,13006565961,11873426079.0,1133139882.0,2839761298,468380174,591046376,606595395.0,-15549019.0,157354970170,151675447574,123206153496.0,239308428.0,
20130819,154828299983,7878352329,7565261218.0,313091111.0,2907723962,458511012,427495712,437364874.0,-9869162.0,157736023945,151920576021,81442845240.0,177033982.0,
20130820,155661493166,8705919775,7872726592.0,833193183.0,2935192988,473710694,432898632,417698950.0,15199682.0,158596686154,152726300178,88993606102.0,227729376.0,
20130821,156834706420,6940768662,5767555408.0,1173213254.0,2866554016,456856009,306865258,323719943.0,-16854685.0,159701260436,153968152404,72795118389.0,160526121.0,
20130822,157187498032,7154595112,6801803500.0,352791612.0,2864261101,451704878,296577412,301728543.0,-5151131.0,160051759133,154323236931,76225782637.0,189244344.0,
20130823,157206691091,9468849165,9449656106.0,19193059.0,2737223795,434019283,373467241,391152836.0,-17685595.0,159943914886,154469467296,94889810864.0,207405648.0,
20130826,158142844823,10303492304,9367338572.0,936153732.0,2962018629,461360635,449671375,422330023.0,27341352.0,161104863452,155180826194,99058068212.0,373020235.0,
20130827,159897225927,10505399464,8751018360.0,1754381104.0,2907627936,455087313,382970001,389243323.0,-6273322.0,162804853863,156989597991,104227016407.0,500445581.0,
20130828,162036114549,12670096372,10531207750.0,2138888622.0,2867436147,459271193,410235222,406051342.0,4183880.0,164903550696,159168678402,131803572412.0,569748859.0,
20130829,163646162418,10194973629,8584925760.0,1610047869.0,2783127447,449724419,318545128,328091902.0,-9546774.0,166429289865,160863034971,105015970532.0,408004117.0,
20130830,162731361276,12066151492,12980952634.0,-914801142.0,2786331383,441431963,398632179,406924635.0,-8292456.0,165517692659,159945029893,131581687608.0,594464764.0,
20130902,164203170766,10893889831,9422080341.0,1471809490.0,2793804345,441640321,352991068,352782710.0,208358.0,166996975111,161409366421,121150799586.0,349889239.0,
20130903,163836243571,9264282240,9631209435.0,-366927195.0,2799921927,455211449,309326278,295755150.0,13571128.0,166636165498,161036321644,112578640208.0,228996057.0,
20130904,164744972424,10667189067,9758460214.0,908728853.0,2814405924,461955387,326141151,319397213.0,6743938.0,167559378348,161930566500,116365902917.0,262420103.0,
20130905,165979329356,9804211049,8569854117.0,1234356932.0,2760954500,452218205,279374936,289112118.0,-9737182.0,168740283856,163218374856,105862668835.0,205906983.0,
20130906,166841574757,11281155028,10418909627.0,862245401.0,2758154510,458059741,387077105,381235569.0,5841536.0,169599729267,164083420247,118851368406.0,590521578.0,
20130909,170263953063,19419627776,15997249470.0,3422378306.0,3326596369,572841053,643061268,528279956.0,114781312.0,173590549432,166937356694,179406389626.0,492196266.0,
20130910,173742910141,20039717034,16560759956.0,3478957078.0,3327962635,569671648,534984688,538154093.0,-3169405.0,177070872776,170414947506,191101980423.0,568743584.0,
20130911,175218296628,19066763751,17591377264.0,1475386487.0,3342404054,578514557,434966296,426123387.0,8842909.0,178560700682,171875892574,195697702160.0,530630295.0,
20130912,178704168813,18661489213,15175617028.0,3485872185.0,3574484088,597504616,535453455,516463396.0,18990059.0,182278652901,175129684725,167425646894.0,451053138.0,
20130913,180047463400,14794724049,13451429462.0,1343294587.0,3247774810,540120825,360354435,417738226.0,-57383791.0,183295238210,176799688590,140856935938.0,763093493.0,
20130916,182712428747,15316387321,12651421974.0,2664965347.0,3159050563,522282478,379393184,397231531.0,-17838347.0,185871479310,179553378184,133868846638.0,432544119.0,
20130917,184432606809,15108935690,13388757628.0,1720178062.0,2863619152,448774820,315685231,389192889.0,-73507658.0,187296225961,181568987657,132366409590.0,401205868.0,
20130918,183564952864,10866924948,11734578893.0,-867653945.0,2705430781,411050650,353696624,391420794.0,-37724170.0,186270383645,180859522083,102273480223.0,445526789.0,
20130923,186139026272,13746039404,11171965996.0,2574073408.0,2853246774,444150091,369637645,336538204.0,33099441.0,188992273046,183285779498,121226920480.0,583920853.0,
20130924,187832693086,15891243985,14197577171.0,1693666814.0,2728328302,417705709,386715705,413160087.0,-26444382.0,190561021388,185104364784,142939011581.0,545895911.0,
20130925,188780192009,14754504704,13807005781.0,947498923.0,2709037025,409763163,368654953,376597499.0,-7942546.0,191489229034,186071154984,143358264639.0,680046397.0,
20130926,189696837512,13657728519,12741083016.0,916645503.0,2451235734,358659121,355831218,406935260.0,-51104042.0,192148073246,187245601778,125560495939.0,539769344.0,
20130927,189444140376,10876838276,11129535412.0,-252697136.0,2338569970,331914844,317802283,344546560.0,-26744277.0,191782710346,187105570406,98075767533.0,458621938.0,
20130930,187007772810,9374945480,11811313046.0,-2436367566.0,2277092903,316975815,246562420,261501449.0,-14939029.0,189284865713,184730679907,88703489169.0,373239987.0,
20131008,190620546052,15019950957,11407177715.0,3612773242.0,2507698233,366879711,384258607,334354711.0,49903896.0,193128244285,188112847819,114809947228.0,340369970.0,
20131009,193433461807,13769689813,10956774058.0,2812915755.0,2456450737,357359138,375571559,385092132.0,-9520573.0,195889912544,190977011070,117800198943.0,335977823.0,
20131010,195962993170,15182552559,12653021196.0,2529531363.0,2354044553,339648905,340165921,357876154.0,-17710233.0,198317037723,193608948617,136370084260.0,353372028.0,
20131011,197583295389,15382323544,13762021325.0,1620302219.0,2467334758,359200108,441604632,422053429.0,19551203.0,200050630147,195115960631,142259459833.0,549634717.0,
20131014,200189301778,16401031686,13795025297.0,2606006389.0,2495987584,367437599,393230731,384993240.0,8237491.0,202685289362,197693314194,151543913439.0,411674788.0,
20131015,202446094767,14754585887,12497792898.0,2256792989.0,2497712626,366045786,344150755,345542568.0,-1391813.0,204943807393,199948382141,138302607877.0,315728183.0,
20131016,202459072287,14308912267,14295934747.0,12977520.0,2307926333,333200336,352876240,385721690.0,-32845450.0,204766998620,200151145954,138003223798.0,384505833.0,
20131017,203294640806,11697484959,10861916440.0,835568519.0,2324039569,346092176,314307037,301415197.0,12891840.0,205618680375,200970601237,113045074977.0,365487832.0,
20131018,202632187972,9052738286,9715191120.0,-662452834.0,2392196627,363569973,340294381,322816584.0,17477797.0,205024384599,200239991345,90628213678.0,235785663.0,
20131021,204341953702,13903779523,12194013793.0,1709765730.0,2472862227,371051278,464469181,456987876.0,7481305.0,206814815929,201869091475,123647670248.0,416879796.0,
20131022,205600238723,14930082234,13671797213.0,1258285021.0,2448248584,368793983,407944680,410201975.0,-2257295.0,208048487307,203151990139,134532362544.0,650759162.0,
20131023,205582514365,12942644847,12960369205.0,-17724358.0,2381959619,366302833,473153968,475645118.0,-2491150.0,207964473984,203200554746,125524723059.0,305050751.0,
20131024,206258104969,9279885380,8604294776.0,675590604.0,2350893103,365061476,366287337,367528694.0,-1241357.0,208608998072,203907211866,90246209726.0,208322608.0,
20131025,206294779848,10652188072,10615513193.0,36674879.0,2233689869,340504377,338160431,362717530.0,-24557099.0,208528469717,204061089979,99564328219.0,294591515.0,
20131028,207060004715,8194772139,7429547272.0,765224867.0,2273933933,344384698,325363016,321482695.0,3880321.0,209333938648,204786070782,78180529925.0,167355619.0,
20131029,205671288019,12384293585,13773010281.0,-1388716696.0,2334651767,351767184,518587949,511205463.0,7382486.0,208005939786,203336636252,117123896912.0,331083768.0,
20131030,205960182509,10483842273,10194947783.0,288894490.0,2493786032,391498211,477256380,437525353.0,39731027.0,208453968541,203466396477,95352489641.0,157216667.0,
20131031,205743564821,9119163699,9335781387.0,-216617688.0,2410668233,384826016,363523110,370195305.0,-6672195.0,208154233054,203332896588,88710032144.0,186089489.0,
20131101,204392050866,7333884215,8685398170.0,-1351513955.0,2426487149,387365408,336480756,333941364.0,2539392.0,206818538015,201965563717,76520643775.0,142653613.0,
20131104,205076226328,7331468487,6647293025.0,684175462.0,2477597195,396486629,299001952,289880731.0,9121221.0,207553823523,202598629133,66304456858.0,86477602.0,
20131105,205472045476,8215742533,7819923385.0,395819148.0,2496007077,399299586,368508807,365695850.0,2812957.0,207968052553,202976038399,78003229727.0,159333854.0,
20131106,205683423245,9209313933,8997936164.0,211377769.0,2429767206,386999073,375285339,387585852.0,-12300513.0,208113190451,203253656039,86444883262.0,220002356.0,
20131107,205764221280,7550981079,7470183044.0,80798035.0,2345686986,389870040,323705640,320834673.0,2870967.0,208109908266,203418534294,70306724176.0,162514090.0,
20131108,205288449011,7553280095,8029052364.0,-475772269.0,2135590463,344690470,333473813,378653383.0,-45179570.0,207424039474,203152858548,70131357831.0,232824334.0,
20131111,205042273510,6425591468,6671766969.0,-246175501.0,2177365481,373798185,307234108,278126393.0,29107715.0,207219638991,202864908029,59901515395.0,126662434.0,
20131112,204586680613,7050099028,7505691925.0,-455592897.0,2366914676,413180144,334986582,295604623.0,39381959.0,206953595289,202219765937,69075405090.0,168936680.0,
20131113,203714786414,7971881104,8843775303.0,-871894199.0,2291868589,389609409,298198432,321769167.0,-23570735.0,206006655003,201422917825,73394354875.0,153848318.0,
20131114,204094642394,8086155715,7706299735.0,379855980.0,2432882670,413585407,391075257,367099259.0,23975998.0,206527525064,201661759724,72247250787.0,183369918.0,
20131115,204613488552,12875770762,12356924604.0,518846158.0,2471550714,416139904,475180877,472626380.0,2554497.0,207085039266,202141937838,113244025742.0,272428674.0,
20131118,206617132564,17385149820,15381505808.0,2003644012.0,3031303176,534028529,590106038,472217413.0,117888625.0,209648435740,203585829388,143566825181.0,250918774.0,
20131119,208019451901,14291513606,12889194269.0,1402319337.0,2945513244,494243074,358409734,398195189.0,-39785455.0,210964965145,205073938657,116056988519.0,214416173.0,
20131120,209551620382,11941657028,10409488547.0,1532168481.0,2899116267,476549154,301975097,319669017.0,-17693920.0,212450736649,206652504115,104883067104.0,186644087.0,
20131121,210072572200,14047646788,13526694970.0,520951818.0,2836659491,456017443,446905061,467436772.0,-20531711.0,212909231691,207235912709,120390436529.0,207725658.0,
20131122,209874858137,12613775426,12811489489.0,-197714063.0,2790740399,439028276,361300354,378289521.0,-16989167.0,212665598536,207084117738,102622388251.0,129110755.0,
20131125,210513952379,11502984333,10863890091.0,639094242.0,2766978465,437176325,386004112,387856063.0,-1851951.0,213280930844,207746973914,96841174853.0,167764763.0,
20131126,211631484011,10115487484,8997955852.0,1117531632.0,2740380984,420454976,352605025,369326374.0,-16721349.0,214371864995,208891103027,84496046982.0,221019018.0,
20131127,212898156243,13499390746,12232718514.0,1266672232.0,2796133632,418182873,512622586,514894689.0,-2272103.0,215694289875,210102022611,102614286080.0,145279204.0,
20131128,213683293087,15322298770,14537161926.0,785136844.0,2760348375,406972873,501833255,513043255.0,-11210000.0,216443641462,210922944712,120011711556.0,250575263.0,
20131129,214338911415,12276834363,11621216035.0,655618328.0,2658498226,350778504,303102807,359297176.0,-56194369.0,216997409641,211680413189,97844547410.0,155183098.0,
20131202,214501095497,18825414865,18663230783.0,162184082.0,2871419826,409942747,583814195,524649952.0,59164243.0,217372515323,211629675671,151842247726.0,345702242.0,
20131203,215434592177,11588419026,10654922346.0,933496680.0,2875096546,412217007,397853341,395579081.0,2274260.0,218309688723,212559495631,101114761744.0,198957066.0,
20131204,217474470295,16912819278,14872941160.0,2039878118.0,2920550103,412208484,634296804,634305327.0,-8523.0,220395020398,214553920192,135314119761.0,384302459.0,
20131205,218992823965,13270367701,11752014031.0,1518353670.0,2908320533,387724054,484020701,508505131.0,-24484430.0,221901144498,216084503432,106203574514.0,190102669.0,
20131206,219018926924,11386150208,11360047249.0,26102959.0,2687886724,345786178,425520920,467458796.0,-41937876.0,221706813648,216331040200,92436056204.0,150606510.0,
20131209,219870191278,10295777349,9444512995.0,851264354.0,2691086939,359392520,444643920,431037578.0,13606342.0,222561278217,217179104339,98127483315.0,174117477.0,
20131210,220430882924,10904198792,10343507146.0,560691646.0,2719960237,362807454,413847769,410432835.0,3414934.0,223150843161,217710922687,95530249161.0,347608385.0,
20131211,221251487178,11396977221,10576372967.0,820604254.0,2439830624,299368754,319960864,383399564.0,-63438700.0,223691317802,218811656554,94439803894.0,227964840.0,
20131212,221822316366,9104756903,8533927715.0,570829188.0,2475665080,310135655,344642278,333875377.0,10766901.0,224297981446,219346651286,78893346793.0,173412495.0,
20131213,222160998519,8306245916,7967563763.0,338682153.0,2400704905,301534200,301663085,310264540.0,-8601455.0,224561703424,219760293614,72788350833.0,148604279.0,
20131216,222639526363,10065271956,9586744112.0,478527844.0,2295022879,293988236,380482967,388028931.0,-7545964.0,224934549242,220344503484,86527296738.0,166310054.0,
20131217,223119201208,7944323087,7464648242.0,479674845.0,2289216797,295652201,441217017,439553052.0,1663965.0,225408418005,220829984411,67967580203.0,102313873.0,
20131218,223477645995,6566113157,6207668370.0,358444787.0,2331707768,300506152,413646467,408792516.0,4853951.0,225809353763,221145938227,56399977611.0,86668014.0,
20131219,223938461000,7640597803,7179782798.0,460815005.0,2222825167,283875618,409196018,425826552.0,-16630534.0,226161286167,221715635833,61496763925.0,133705545.0,
20131220,224521974124,8431881585,7848368461.0,583513124.0,1991697488,237090064,359249900,406035454.0,-46785554.0,226513671612,222530276636,72226488636.0,144800457.0,
20131223,224630867846,6322420368,6213526646.0,108893722.0,2056358199,253981537,371608489,354717016.0,16891473.0,226687226045,222574509647,58882942432.0,117710611.0,
20131224,224885880852,7147729797,6892716791.0,255013006.0,1623243047,235599691,364602298,382984144.0,-18381846.0,226509123899,223262637805,62196640722.0,168750646.0,
20131225,225648698731,7189385295,6426567416.0,762817879.0,1601746673,222519884,384986688,398066495.0,-13079807.0,227250445404,224046952058,58772372715.0,148041956.0,
20131226,226080169376,7599426050,7167955405.0,431470645.0,1555870062,219639719,368615931,371496096.0,-2880165.0,227636039438,224524299314,66741009915.0,121704221.0,
20131227,226225117946,7154176521,7009227951.0,144948570.0,1633137598,235543329,338202390,322298780.0,15903610.0,227858255544,224591980348,67366971886.0,118012381.0,
20131230,227841453605,7661097572,6044761913.0,1616335659.0,1576943369,223145036,352047019,364445312.0,-12398293.0,229418396974,226264510236,63642595014.0,93046923.0,
20131231,227978800560,8322266045,8184919090.0,137346955.0,1941704951,281121010,395736654,337760680.0,57975974.0,229920505511,226037095609,73446404472.0,118208532.0,
20140102,228710320652,7318939312,6587419220.0,731520092.0,1557077302,224484301,266695937,323332646.0,-56636709.0,230267397954,227153243350,62274318345.0,83526153.0,
20140103,228595221625,8292729532,8407828559.0,-115099027.0,1513927862,214560754,305042145,314965692.0,-9923547.0,230109149487,227081293763,72785920613.0,145434523.0,
20140106,228761343756,8036279087,7870156956.0,166122131.0,1523790712,215850289,329112079,327822544.0,1289535.0,230285134468,227237553044,73032856615.0,188382751.0,
20140107,228638358705,5910246628,6033231679.0,-122985051.0,1583705720,235286454,368645925,349209760.0,19436165.0,230222064425,227054652985,54560024678.0,135419150.0,
20140108,229156113820,7463940724,6946185609.0,517755115.0,1636238245,242021069,389624522,382889907.0,6734615.0,230792352065,227519875575,62994679896.0,109107605.0,
20140109,230020088540,8847269593,7983294873.0,863974720.0,1593767536,238660143,413420487,416781413.0,-3360926.0,231613856076,228426321004,67624028931.0,131532041.0,
20140110,229737294553,7004169454,7286963441.0,-282793987.0,1537336124,231295830,319225435,326589748.0,-7364313.0,231274630677,228199958429,61089275003.0,118478762.0,
20140113,229499201270,6346364908,6584458191.0,-238093283.0,1568228234,229413614,462661185,464543401.0,-1882216.0,231067429504,227930973036,56727501735.0,119562926.0,
20140114,229311743389,6685515130,6872973011.0,-187457881.0,1608590091,241626323,362113144,349900435.0,12212709.0,230920333480,227703153298,56680071675.0,82032033.0,
20140115,229811843792,7343289231,6843188828.0,500100403.0,1597822610,234939151,332330199,339017371.0,-6687172.0,231409666402,228214021182,57762390395.0,72941435.0,
20140116,230060965821,7656168912,7407046883.0,249122029.0,1627160554,239050510,329057994,324946635.0,4111359.0,231688126375,228433805267,62889779807.0,86490103.0,
20140117,230412377549,6844410935,6492999207.0,351411728.0,1526453295,216779452,281672856,303943914.0,-22271058.0,231938830844,228885924254,57338134238.0,70494859.0,
20140120,230791913661,5607296766,5227760654.0,379536112.0,1499170924,212692229,239283326,243370549.0,-4087223.0,232291084585,229292742737,48583035170.0,87015282.0,
20140121,230777571850,6968031351,6982373162.0,-14341811.0,1502450099,217439214,308110357,303363372.0,4746985.0,232280021949,229275121751,52153848335.0,87483215.0,
20140122,231326049737,10873150808,10324672921.0,548477887.0,1619788087,264444360,392040765,345035619.0,47005146.0,232945837824,229706261650,84197909197.0,219672263.0,
20140123,231945821615,10130547148,9510775270.0,619771878.0,1495065117,220619872,280726467,324550955.0,-43824488.0,233440886732,230450756498,76120105521.0,160463454.0,
20140124,231774564282,10368793788,10540051121.0,-171257333.0,1391626771,190789333,362572139,392402678.0,-29830539.0,233166191053,230382937511,82442127423.0,168429179.0,
20140127,232466131188,10823464032,10131897126.0,691566906.0,1323031454,183628045,288632280,295793568.0,-7161288.0,233789162642,231143099734,82407962675.0,131862099.0,
20140128,231923649468,7893789417,8436271137.0,-542481720.0,1349330588,187152618,255296701,251772128.0,3524573.0,233272980056,230574318880,66207072616.0,136335391.0,
20140129,230617999048,8042093293,9347743713.0,-1305650420.0,1337871390,185304033,208615454,210464039.0,-1848585.0,231955870438,229280127658,67740630336.0,125291927.0,
20140130,227890201770,7046396520,9774193798.0,-2727797278.0,1158623034,152716226,207762324,240350131.0,-32587807.0,229048824804,226731578736,58201102682.0,106938028.0,
20140207,230299148177,10055176584,7646230177.0,2408946407.0,1303402675,172647885,303879043,283947384.0,19931659.0,231602550852,228995745502,67874545949.0,164043795.0,
20140210,233894222460,15675885762,12080811479.0,3595074283.0,1481220821,225887393,427008003,373768495.0,53239508.0,235375443281,232413001639,113008742284.0,224480716.0,
20140211,237113578259,17047728070,13828372271.0,3219355799.0,1588789186,252608067,529137869,502417195.0,26720674.0,238702367445,235524789073,125249676424.0,244991394.0,
20140212,239798698269,14427258810,11742138800.0,2685120010.0,1556251316,238999956,444801939,458410050.0,-13608111.0,241354949585,238242446953,110801401453.0,232379096.0,
20140213,242214544627,16575349032,14159502674.0,2415846358.0,1598740564,254394920,484546617,469151653.0,15394964.0,243813285191,240615804063,124460951656.0,213322128.0,
20140214,242428321403,11422214895,11208438119.0,213776776.0,1540651251,228509451,288082468,313967937.0,-25885469.0,243968972654,240887670152,97569340767.0,198451857.0,
20140217,244480638839,16297930378,14245612942.0,2052317436.0,1609881723,234841562,351927197,345595086.0,6332111.0,246090520562,242870757116,126305557270.0,206435188.0,
20140218,246823602738,16987912093,14644948194.0,2342963899.0,1524191379,215374452,521044568,540511678.0,-19467110.0,248347794117,245299411359,129927273323.0,259985196.0,
20140219,248756501420,16467807361,14534908679.0,1932898682.0,1710771073,263589732,544344331,496129051.0,48215280.0,250467272493,247045730347,128217225317.0,162739169.0,
20140220,249861080842,16705939916,15601360494.0,1104579422.0,1702618265,270187624,485700886,479102994.0,6597892.0,251563699107,248158462577,131088230638.0,197039858.0,
20140221,249701725590,12045784878,12205140130.0,-159355252.0,1549862047,237719811,303760600,336228413.0,-32467813.0,251251587637,248151863543,99399827008.0,136512168.0,
20140224,250050968636,13189674622,12840431576.0,349243046.0,1480014536,216281062,420273062,441711811.0,-21438749.0,251530983172,248570954100,107380236382.0,257390850.0,
20140225,249672061830,15187411554,15566318360.0,-378906806.0,1436846056,215305068,409132399,410108393.0,-975994.0,251108907886,248235215774,127672990709.0,334736805.0,
20140226,250664112715,11539038673,10546987788.0,992050885.0,1410092409,221440769,413732928,407597227.0,6135701.0,252074205124,249254020306,95915156308.0,257492498.0,
20140227,250675886815,13592753313,13580979213.0,11774100.0,1624211532,269433840,576954165,528961094.0,47993071.0,252300098347,249051675283,112950710581.0,220762321.0,
20140228,250685575955,11898490852,11888801712.0,9689140.0,1590875805,249070155,453430707,473794392.0,-20363685.0,252276451760,249094700150,95518885118.0,201109976.0,
20140303,251983073596,12657075837,11359578196.0,1297497641.0,1677166495,279935937,414288005,383422223.0,30865782.0,253660240091,250305907101,104885821313.0,232965957.0,
20140304,252351780621,12125200646,11756493621.0,368707025.0,1699560915,291377717,419070658,407628878.0,11441780.0,254051341536,250652219706,101587705101.0,191848537.0,
20140305,253240132979,11196972813,10308620455.0,888352358.0,1750662801,299624044,364577596,356331269.0,8246327.0,254990795780,251489470178,91547727961.0,174347260.0,
20140306,253730966768,11798471888,11307638099.0,490833789.0,1704549281,276332011,447122447,470414480.0,-23292033.0,255435516049,252026417487,92621899519.0,181897239.0,
20140307,253050872759,11198350419,11878444428.0,-680094009.0,1793411804,304513619,350246872,322065264.0,28181608.0,254844284563,251257460955,89304801585.0,107730936.0,
20140310,252414971026,11738421987,12374323720.0,-635901733.0,1830208829,362900252,449345548,390958915.0,58386633.0,254245179855,250584762197,94908391435.0,212044172.0,
20140311,252038649300,9244370725,9620692451.0,-376321726.0,1917867637,388371182,518475094,493004164.0,25470930.0,253956516937,250120781663,77082166560.0,121862986.0,
20140312,251945854288,10131458341,10224253353.0,-92795012.0,1997247313,422673168,519314091,485012105.0,34301986.0,253943101601,249948606975,79187167885.0,115984832.0,
20140313,252761075051,10331280705,9516059942.0,815220763.0,2192453531,483937455,516236308,454972021.0,61264287.0,254953528582,250568621520,77935565092.0,96143621.0,
20140314,252331071010,8951176202,9381180243.0,-430004041.0,2151721772,488064245,289536899,285410109.0,4126790.0,254482792782,250179349238,70167586896.0,89499816.0,
20140317,253043587759,9484884772,8772368023.0,712516749.0,2184786624,492981307,346139134,341222072.0,4917062.0,255228374383,250858801135,72175033473.0,98106125.0,
20140318,254150400180,11016382497,9909570076.0,1106812421.0,2153234090,488658181,307781284,312104410.0,-4323126.0,256303634270,251997166090,83777178591.0,126602219.0,
20140319,255575562621,10216100311,8790937870.0,1425162441.0,2053149380,449441334,329802162,369019009.0,-39216847.0,257628712001,253522413241,80219232543.0,107848274.0,
20140320,255559503792,10997485798,11013544627.0,-16058829.0,1946992062,390205441,408416362,467652255.0,-59235893.0,257506495854,253612511730,88759976071.0,152306959.0,
20140321,255770666920,14222628366,14011465238.0,211163128.0,1740051312,306673488,694067021,777598974.0,-83531953.0,257510718232,254030615608,109409113812.0,210603859.0,
20140324,257147141519,14887597993,13511123394.0,1376474599.0,1905006670,358982196,534188976,481880268.0,52308708.0,259052148189,255242134849,110695934377.0,164511525.0,
20140325,258315904924,12745301869,11576538464.0,1168763405.0,1903062121,359963463,419892694,418911427.0,981267.0,260218967045,256412842803,100878427180.0,235407969.0,
20140326,259400663608,10473570962,9388812278.0,1084758684.0,1927608947,365487641,375383768,369859590.0,5524178.0,261328272555,257473054661,80797168544.0,129626567.0,
20140327,260095867854,12509484624,11814280378.0,695204246.0,1858453331,341174945,527446678,551759374.0,-24312696.0,261954321185,258237414523,95251143038.0,129527095.0,
20140328,259105897661,10963018786,11952988979.0,-989970193.0,1781791692,322624543,351554903,370105305.0,-18550402.0,260887689353,257324105969,94121946348.0,187185288.0,
20140331,258890954278,8313336207,8528279590.0,-214943383.0,1788598988,315372340,320555736,327807939.0,-7252203.0,260679553266,257102355290,71757971856.0,145895267.0,
20140401,258455252144,7454147839,7889849973.0,-435702134.0,1882870067,329582717,299476363,285265986.0,14210377.0,260338122211,256572382077,64610408564.0,86203464.0,
20140402,258348609225,9776632960,9883275879.0,-106642919.0,2028112154,357172759,509755055,482165013.0,27590042.0,260376721379,256320497071,78645722249.0,92521870.0,
20140403,259439552720,10708696243,9617752748.0,1090943495.0,1951085811,338802278,515881175,534251656.0,-18370481.0,261390638531,257488466909,80234500208.0,91834500.0,
20140404,258587521605,8204649460,9056680575.0,-852031115.0,1915929285,323644312,386841831,401999797.0,-15157966.0,260503450890,256671592320,66491453400.0,86733303.0,
20140408,259332941260,15064019071,14318599416.0,745419655.0,2142303390,379430465,677734271,621948118.0,55786153.0,261475244650,257190637870,108123365146.0,107886703.0,
20140409,260538989557,12507535371,11301487074.0,1206048297.0,2046832746,340435478,378482964,417477951.0,-38994987.0,262585822303,258492156811,87327468862.0,139678014.0,
20140410,262944130727,19699552948,17294411778.0,2405141170.0,2251706479,395589445,579654220,524500253.0,55153967.0,265195837206,260692424248,130012514980.0,144843794.0,
20140411,262883689026,14611841647,14672283348.0,-60441701.0,2175945347,384965781,436033396,446657060.0,-10623664.0,265059634373,260707743679,111646401736.0,127931248.0,
20140414,264564175463,12074556314,10394069877.0,1680486437.0,2121974869,367306449,367334437,384993769.0,-17659332.0,266686150332,262442200594,87288579335.0,144497379.0,
20140415,266244836275,13534438812,11853778000.0,1680660812.0,1903452565,314794767,294872317,347383999.0,-52511682.0,268148288840,264341383710,91554463756.0,122939511.0,
20140416,266555259816,10267873861,9957450320.0,310423541.0,1975243309,330635368,362009563,346168962.0,15840601.0,268530503125,264580016507,75352838266.0,88550572.0,
20140417,266776778235,10134509283,9912990864.0,221518419.0,1934603170,330355879,324658411,324937900.0,-279489.0,268711381405,264842175065,74528873590.0,87813936.0,
20140418,266499969446,9577431792,9854240581.0,-276808789.0,1794892129,287242016,374983845,418097708.0,-43113863.0,268294861575,264705077317,73701517092.0,89311782.0,
20140421,266692676276,11210339116,11017632286.0,192706830.0,1769176200,301789768,477960722,463412970.0,14547752.0,268461852476,264923500076,82166197787.0,126197457.0,
20140422,266870388802,11267977775,11090265249.0,177712526.0,1799916359,305325870,498582898,495046796.0,3536102.0,268670305161,265070472443,83050225143.0,136616737.0,
20140423,267460402473,8985208087,8395194416.0,590013671.0,1860871023,325476173,431177873,411027570.0,20150303.0,269321273496,265599531450,67437833181.0,85700368.0,
20140424,266725968953,8580516470,9314949990.0,-734433520.0,1905803549,348963789,422788291,399300675.0,23487616.0,268631772502,264820165404,64367739254.0,80954770.0,
20140425,265576759765,9783865720,10933074908.0,-1149209188.0,1721207938,290233116,398306780,457037453.0,-58730673.0,267297967703,263855551827,75867375221.0,109088575.0,
20140428,264627794987,8967146941,9916111719.0,-948964778.0,1613005629,257761033,428957376,461429459.0,-32472083.0,266240800616,263014789358,68423893065.0,117599504.0,
20140429,263634326264,7772909913,8766378636.0,-993468723.0,1691287829,264533302,463996527,457224258.0,6772269.0,265325614093,261943038435,56794072399.0,90315416.0,
20140430,262009980050,7247352226,8871698440.0,-1624346214.0,1635791841,248958249,321016213,336591266.0,-15575053.0,263645771891,260374188209,57707790646.0,118246301.0,
20140505,263125449389,8516572164,7401102825.0,1115469339.0,1728998220,279157134,437716918,407518033.0,30198885.0,264854447609,261396451169,60068407477.0,75520255.0,
20140506,263870108487,8424672721,7680013623.0,744659098.0,1790872794,291324162,485860492,473693464.0,12167028.0,265660981281,262079235693,57938557138.0,59117418.0,
20140507,263849484060,7547560079,7568184506.0,-20624427.0,1783931061,291050868,433098190,433371484.0,-273294.0,265633415121,262065552999,57782336486.0,97721128.0,
20140508,263640476055,7985052061,8194060066.0,-209008005.0,1789704684,294182863,378944870,375812875.0,3131995.0,265430180739,261850771371,59670478582.0,83526968.0,
20140509,262894808767,7334172832,8079840120.0,-745667288.0,1705756394,263259050,409249410,440173223.0,-30923813.0,264600565161,261189052373,57688713230.0,74509583.0,
20140512,263336148453,12716672910,12275333224.0,441339686.0,1887908530,316539590,517233276,463952736.0,53280540.0,265224056983,261448239923,88039043148.0,143644747.0,
20140513,263875665230,10210290975,9670774198.0,539516777.0,1857824098,300233901,341660691,357966380.0,-16305689.0,265733489328,262017841132,73657609112.0,110204937.0,
20140514,263785295626,7703544903,7793914507.0,-90369604.0,1827570230,302805472,376333959,373762388.0,2571571.0,265612865856,261957725396,56845853258.0,78108439.0,
20140515,263365496848,8055799282,8475598060.0,-419798778.0,1714345106,261473338,436143161,477475295.0,-41332134.0,265079841954,261651151742,59837715883.0,111465745.0,
20140516,262504748253,6777228354,7637976949.0,-860748595.0,1674467649,254283436,358331263,365521165.0,-7189902.0,264179215902,260830280604,52040512130.0,81106739.0,
20140519,262978461564,8257521627,7783808316.0,473713311.0,1636149807,256420841,411757235,409619830.0,2137405.0,264614611371,261342311757,52929958440.0,68507487.0,
20140520,263329869576,7378819909,7027411897.0,351408012.0,1660684994,264519437,407006502,398907906.0,8098596.0,264990554570,261669184582,49939099339.0,68415497.0,
20140521,263711250561,7437968535,7056587550.0,381380985.0,1769018748,290253832,554334184,528599789.0,25734395.0,265480269309,261942231813,48702759733.0,64781690.0,
20140522,263285667241,8451473422,8877056742.0,-425583320.0,1758195332,293952400,411065463,407366895.0,3698568.0,265043862573,261527471909,59423046336.0,97779066.0,
20140523,262179721956,7232471152,8338416437.0,-1105945285.0,1742951754,289470665,421775919,426257654.0,-4481735.0,263922673710,260436770202,51565755716.0,74478271.0,
20140526,261798286090,8649747489,9031183355.0,-381435866.0,1769480155,289836117,435522588,435157136.0,365452.0,263567766245,260028805935,60357262115.0,63942326.0,
20140527,262184505749,8449243396,8063023737.0,386219659.0,1786177552,294368537,464635704,460103284.0,4532420.0,263970683301,260398328197,56297444134.0,46820246.0,
20140528,262495558871,10723796154,10412743032.0,311053122.0,1849684934,312371350,478352223,460349410.0,18002813.0,264345243805,260645873937,68942082944.0,79117471.0,
20140529,261867723917,9774455584,10402290538.0,-627834954.0,1773432798,288072807,402510032,426808575.0,-24298543.0,263641156715,260094291119,69484232514.0,82021269.0,
20140530,260267422226,8167969061,9768270752.0,-1600301691.0,1702233281,270315721,393229868,410986954.0,-17757086.0,261969655507,258565188945,62649962779.0,114736885.0,
20140603,259934197396,8771506084,9104730914.0,-333224830.0,1785620918,291677668,481673233,460311286.0,21361947.0,261719818314,258148576478,59215995534.0,94917105.0,
20140604,259577930516,8028118877,8384385757.0,-356266880.0,1702384698,271997131,395633241,415313778.0,-19680537.0,261280315214,257875545818,57430737019.0,65365465.0,
20140605,258996504218,7718020196,8299446494.0,-581426298.0,1793129953,294637183,383802206,361162154.0,22640052.0,260789634171,257203374265,56454639292.0,59187861.0,
20140606,258783819562,7841012896,8053697552.0,-212684656.0,1676569971,262974892,346320349,377982640.0,-31662291.0,260460389533,257107249591,55181769542.0,52652600.0,
20140609,258813086318,7991678955,7962412199.0,29266756.0,1790513118,295477968,468188414,435685338.0,32503076.0,260603599436,257022573200,55126350306.0,48961830.0,
20140610,258915454209,9738387204,9636019313.0,102367891.0,1925383864,330908321,495122774,459692421.0,35430353.0,260840838073,256990070345,65605356818.0,59447491.0,
20140611,259331157651,9242894688,8827191246.0,415703442.0,1902826720,313315711,418877395,436470005.0,-17592610.0,261233984371,257428330931,63664165169.0,65550280.0,
20140612,260095159980,9619440443,8855438114.0,764002329.0,1880328796,313294537,389478460,389499634.0,-21174.0,261975488776,258214831184,70437415262.0,85093364.0,
20140613,259234464249,11035429772,11896125503.0,-860695731.0,1932557952,330619081,526948093,509623549.0,17324544.0,261167022201,257301906297,82676664924.0,89327513.0,
20140616,259830180798,10960047052,10364330503.0,595716549.0,2128107268,383097959,554372917,501894039.0,52478878.0,261958288066,257702073530,80168728217.0,76788901.0,
20140617,261262566962,10678375115,9245988951.0,1432386164.0,1986059991,347794481,445866109,481169587.0,-35303478.0,263248626953,259276506971,71265252945.0,76664900.0,
20140618,263464984389,10981607193,8779189766.0,2202417427.0,1905445146,327078543,596836596,617552534.0,-20715938.0,265370429535,261559539243,70515645159.0,69449100.0,
20140619,264416711355,11575621771,10623894805.0,951726966.0,1692954281,272158884,471621209,526540868.0,-54919659.0,266109665636,262723757074,74881608997.0,80396051.0,
20140620,264462000733,7311573935,7266284557.0,45289378.0,1659092486,256773555,455954978,471340307.0,-15385329.0,266121093219,262802908247,54146455557.0,58112727.0,
20140623,264423995477,7984521565,8022526821.0,-38005256.0,1711404991,268562075,509041591,497253071.0,11788520.0,266135400468,262712590486,57864870213.0,75551504.0,
20140624,264557736440,8678669140,8544928177.0,133740963.0,1783361767,298013493,444842281,415390863.0,29451418.0,266341098207,262774374673,62107469350.0,70690016.0,
20140625,264826122031,7798911904,7530526313.0,268385591.0,1729313567,284059871,386524893,400478515.0,-13953622.0,266555435598,263096808464,56333715575.0,68124599.0,
20140626,263901777459,8934494319,9858838891.0,-924344572.0,1705964326,291804496,427774674,420030049.0,7744625.0,265607741785,262195813133,66767677138.0,77949806.0,
20140627,262843748934,10674745540,11732774065.0,-1058028525.0,1670352288,301262117,567235752,557778131.0,9457621.0,264514101222,261173396646,77863893741.0,68969441.0,
20140630,263735543924,11863350290,10971555300.0,891794990.0,1864005213,366129787,571830221,506962551.0,64867670.0,265599549137,261871538711,80165542850.0,88361392.0,
20140701,264607937184,11619124167,10746730907.0,872393260.0,1728225591,299236702,328687972,395581057.0,-66893085.0,266336162775,262879711593,83872410667.0,71934197.0,
20140702,265240147977,12502321252,11870110459.0,632210793.0,1804553417,321647158,511541725,489131269.0,22410456.0,267044701394,263435594560,89635352447.0,82548074.0,
20140703,265974898727,13478521704,12743770954.0,734750750.0,1920076729,354317677,596042331,563371812.0,32670519.0,267894975456,264054821998,96557312297.0,120833460.0,
20140704,265436852269,11209332181,11747378639.0,-538046458.0,1909107890,351429329,457240169,460128517.0,-2888348.0,267345960159,263527744379,83664334685.0,93887980.0,
20140707,266651924011,11498589639,10283517897.0,1215071742.0,1964318103,360983132,459386341,449832538.0,9553803.0,268616242114,264687605908,81462451244.0,89791718.0,
20140708,267771059963,11443120248,10323984296.0,1119135952.0,1941623111,356328337,431865953,436520748.0,-4654795.0,269712683074,265829436852,81789681547.0,92966213.0,
20140709,268976908835,13708146360,12502297488.0,1205848872.0,1837924169,321895785,442627206,477059758.0,-34432552.0,270814833004,267138984666,98847253369.0,110068804.0,
20140710,270150328048,11445433593,10272014380.0,1173419213.0,1789239958,312335779,438918350,448478356.0,-9560006.0,271939568006,268361088090,85791365737.0,83780123.0,
20140711,270336177205,11432852766,11247003609.0,185849157.0,1743881323,304315056,387263768,395284491.0,-8020723.0,272080058528,268592295882,86421184771.0,71857486.0,
20140714,271692944012,14022448475,12665681668.0,1356766807.0,1819218966,320726698,491241717,474830075.0,16411642.0,273512162978,269873725046,97690149732.0,95305138.0,
20140715,272382809571,13649257521,12959391962.0,689865559.0,1887331655,335855032,449671396,434543062.0,15128334.0,274270141226,270495477916,103092763058.0,119028092.0,
20140716,273677477762,13832170116,12537501925.0,1294668191.0,2024579463,368431573,550544268,517967727.0,32576541.0,275702057225,271652898299,102203387413.0,105616165.0,
20140717,274021765613,10449050940,10104763089.0,344287851.0,2020042857,348209476,364431807,384653904.0,-20222097.0,276041808470,272001722756,79537092187.0,112359045.0,
20140718,273067071370,10487979224,11442673467.0,-954694243.0,2050709730,363760230,449770806,434220052.0,15550754.0,275117781100,271016361640,82665223618.0,98456473.0,
20140721,272800679038,10107133251,10373525583.0,-266392332.0,2153674887,395796666,414377242,382340806.0,32036436.0,274954353925,270647004151,75669121401.0,58759034.0,
20140722,273882387833,14498460951,13416752156.0,1081708795.0,2198534959,420753681,673156369,648199354.0,24957015.0,276080922792,271683852874,99016856407.0,92473214.0,
20140723,275745037661,15381414613,13518764785.0,1862649828.0,2215194858,408977710,608947146,620723117.0,-11775971.0,277960232519,273529842803,106633405279.0,115256677.0,
20140724,277337816759,19341209261,17748430163.0,1592779098.0,2523214638,480781456,781324478,709520732.0,71803746.0,279861031397,274814602121,128866988475.0,147863821.0,
20140725,276338715895,16146244265,17145345129.0,-999100864.0,2609137766,485628190,653919936,649073202.0,4846734.0,278947853661,273729578129,111326779796.0,151125194.0,
20140728,275792314276,25330816505,25877218124.0,-546401619.0,3096334488,602367464,837980913,721241639.0,116739274.0,278888648764,272695979788,180552707622.0,231207787.0,
20140729,277436563438,22313772448,20669523286.0,1644249162.0,3273443034,643909616,570960875,529418723.0,41542152.0,280710006472,274163120404,159133214549.0,260616124.0,
20140730,281191829508,21820828528,18065562458.0,3755266070.0,3224125568,621204665,526037245,548742196.0,-22704951.0,284415955076,277967703940,149597417156.0,197698419.0,
20140731,283472878022,19428333365,17147284851.0,2281048514.0,3299144167,637597008,562002156,545609813.0,16392343.0,286772022189,280173733855,132624888408.0,161733119.0,
20140801,282807951055,20877644942,21542571909.0,-664926967.0,3183147027,604541045,499792345,532848308.0,-33055963.0,285991098082,279624804028,151809158083.0,193620972.0,
20140804,285698012007,21361247609,18471186657.0,2890060952.0,3494808384,669994503,622623693,557170235.0,65453458.0,289192820391,282203203623,140400587283.0,145892141.0,
20140805,288090413294,21974257920,19581856633.0,2392401287.0,3367752810,646019448,535884671,559859726.0,-23975055.0,291458166104,284722660484,141648362190.0,152596937.0,
20140806,291615855527,22133809226,18608366993.0,3525442233.0,3394814354,718356226,600292309,527955531.0,72336778.0,295010669881,288221041173,140827491946.0,150321323.0,
20140807,294718230086,21831148630,18728774071.0,3102374559.0,2880806829,553475703,503910514,668791037.0,-164880523.0,297599036915,291837423257,138207611222.0,161093964.0,
20140808,295837518089,16839331892,15720043889.0,1119288003.0,2739068954,511141987,457482616,499816332.0,-42333716.0,298576587043,293098449135,109788123562.0,132879526.0,
20140811,297415010530,19756935325,18179442884.0,1577492441.0,3098591058,595874736,628749710,544016961.0,84732749.0,300513601588,294316419472,126339947740.0,189822653.0,
20140812,300455598098,20662634626,17622047058.0,3040587568.0,2993821657,566152801,519066175,548788110.0,-29721935.0,303449419755,297461776441,133356008624.0,182147120.0,
20140813,304160550816,22784891797,19079939079.0,3704952718.0,2941328293,549787632,552469178,568834347.0,-16365169.0,307101879109,301219222523,146581612454.0,318684198.0,
20140814,307293179271,21440618954,18307990499.0,3132628455.0,2848463783,537777146,524203849,536214335.0,-12010486.0,310141643054,304444715488,141862139957.0,261182536.0,
20140815,308505667412,19882847811,18670359670.0,1212488141.0,2926728670,549070930,648326303,637032519.0,11293784.0,311432396082,305578938742,129765502953.0,178211818.0,
20140818,311144915581,22116914462,19477666293.0,2639248169.0,2928628202,545878941,523299838,526491827.0,-3191989.0,314073543783,308216287379,141619737366.0,217627270.0,
20140819,314000082686,24478938058,21623770953.0,2855167105.0,2971229057,558964767,651976796,638890970.0,13085826.0,316971311743,311028853629,155374435512.0,237444535.0,
20140820,316919893355,21102254552,18182443883.0,2919810669.0,2952936920,559844185,585841603,584962185.0,879418.0,319872830275,313966956435,140003732287.0,221317489.0,
20140821,319781417111,20937372387,18075848631.0,2861523756.0,2783449809,522418447,520977083,558402821.0,-37425738.0,322564866920,316997967302,140722263610.0,253866711.0,
20140822,320712615102,20931605475,20000407484.0,931197991.0,2777758609,539562024,558178032,541034455.0,17143577.0,323490373711,317934856493,140369973824.0,206437992.0,
20140825,322692875254,20660713907,18680453755.0,1980260152.0,2712634191,525815421,621002441,634749044.0,-13746603.0,325405509445,319980241063,134307306217.0,207803894.0,
20140826,324639044384,19645912134,17699743004.0,1946169130.0,2545234947,477910818,514061085,561965688.0,-47904603.0,327184279331,322093809437,134200437952.0,242834931.0,
20140827,327033468171,15775159716,13380735929.0,2394423787.0,2506072682,466948496,621260285,632222607.0,-10962322.0,329539540853,324527395489,104186926491.0,191774829.0,
20140828,331974283614,18075448159,13134632716.0,4940815443.0,2306178645,416710514,647097944,697335926.0,-50237982.0,334280462259,329668104969,109555003710.0,191441532.0,
20140829,333028014188,14869789058,13816058484.0,1053730574.0,2336768882,427854960,584884633,573740187.0,11144446.0,335364783070,330691245306,93101263916.0,181424693.0,
20140901,334993392377,19375199451,17409821262.0,1965378189.0,2353464222,420833944,526996495,534017511.0,-7021016.0,337346856599,332639928155,117606838396.0,232026979.0,
20140902,334304257645,25074482942,25763617674.0,-689134732.0,2575067297,459853238,748140249,709120955.0,39019294.0,336879324942,331729190348,170799640974.0,233648650.0,
20140903,334451881572,28142266923,27994642996.0,147623927.0,2802271135,510673136,754505396,703685498.0,50819898.0,337254152707,331649610437,187599912947.0,243860926.0,
20140904,337616642418,27868392314,24703631468.0,3164760846.0,2987580074,557972740,631924778,584625174.0,47299604.0,340604222492,334629062344,179370799984.0,231038742.0,
20140905,337114774267,27435309267,27937177418.0,-501868151.0,3167707067,607844092,718005670,668134318.0,49871352.0,340282481334,333947067200,186094155987.0,273470804.0,
20140909,342444319645,29429506399,24099961021.0,5329545378.0,3157574813,604878031,674256665,677222726.0,-2966061.0,345601894458,339286744832,172926317841.0,260666322.0,
20140910,347084945437,26516564784,21875938992.0,4640625792.0,2844850067,524305237,689374080,769946874.0,-80572794.0,349929795504,344240095370,163533060450.0,246387991.0,
20140911,351356901278,31551508007,27279552166.0,4271955841.0,2809839184,508336149,813463327,829432415.0,-15969088.0,354166740462,348547062094,197323435512.0,340231484.0,
20140912,354592937514,25877300283,22641264047.0,3236036236.0,2854744948,524061365,677360994,661635778.0,15725216.0,357447682462,351738192566,162819105085.0,256874829.0,
20140915,360155185805,30277233230,24714984939.0,5562248291.0,2786068344,493654518,741223637,771630484.0,-30406847.0,362941254149,357369117461,185730028668.0,335171269.0,
20140916,364561939383,38576347008,34169593430.0,4406753578.0,2675808937,494045733,882829505,882438290.0,391215.0,367237748320,361886130446,237422506313.0,424269669.0,
20140917,368035491871,24747959534,21274407046.0,3473552488.0,2633272090,481116386,759755012,772684359.0,-12929347.0,370668763961,365402219781,159337543486.0,266998045.0,
20140918,371022528916,23454655704,20467618659.0,2987037045.0,2754050358,515412100,910651338,876355624.0,34295714.0,373776579274,368268478558,145076889010.0,241010025.0,
20140919,371414736256,23437077528,23044870188.0,392207340.0,2743342013,505039270,779322832,789695662.0,-10372830.0,374158078269,368671394243,144410440657.0,264169224.0,
20140922,377641662610,26802465503,20575539149.0,6226926354.0,2472695378,444658130,611299373,671680513.0,-60381140.0,380114357988,375168967232,148697601473.0,329635907.0,
20140923,380499940014,22613124910,19754847506.0,2858277404.0,2580377167,476327632,851878416,820208914.0,31669502.0,383080317181,377919562847,135887546394.0,277549221.0,
20140924,388077718595,35224990253,27647211672.0,7577778581.0,2717092663,516421911,1100530763,1060436484.0,40094279.0,390794811258,385360625932,187351809360.0,377106588.0,
20140925,393151191091,35791324236,30717851740.0,5073472496.0,2618340050,488477394,904722652,932667169.0,-27944517.0,395769531141,390532851041,190259535642.0,290700899.0,
20140926,395131055448,27354261183,25374396826.0,1979864357.0,2654825242,519168328,850494322,819803388.0,30690934.0,397785880690,392476230206,148560814078.0,195250249.0,
20140929,393042488212,28613142315,30701709551.0,-2088567236.0,2644410326,507492826,757653472,769328974.0,-11675502.0,395686898538,390398077886,171688789916.0,245945779.0,
20140930,386227534354,27147344071,33962297929.0,-6814953858.0,2402153637,447007098,672778691,733264419.0,-60485728.0,388629687991,383825380717,166876389311.0,313742919.0,
20141008,397396842118,37442090357,26272782593.0,11169307764.0,2836409256,559818258,923699622,810888462.0,112811160.0,400233251374,394560432862,181239495671.0,216548078.0,
20141009,403598187437,36582698297,30381352978.0,6201345319.0,2858754154,547404751,811258045,823671552.0,-12413507.0,406456941591,400739433283,200357818687.0,290861921.0,
20141010,407459730065,34135897574,30274354946.0,3861542628.0,2772753535,536135153,768465628,779735226.0,-11269598.0,410232483600,404686976530,192294154781.0,240909713.0,
20141013,413817989559,31602674452,25244414958.0,6358259494.0,2684864566,519860635,749586286,765860804.0,-16274518.0,416502854125,411133124993,176210095974.0,248597237.0,
20141014,417913475124,30016767013,25921281448.0,4095485565.0,2752285172,534018157,783993509,769835987.0,14157522.0,420665760296,415161189952,170181535393.0,181873290.0,
20141015,422266917101,31845671858,27492229881.0,4353441977.0,2885487467,552337971,774764311,756444497.0,18319814.0,425152404568,419381429634,172511526093.0,173629963.0,
20141016,424530873677,35283134771,33019178195.0,2263956576.0,3010510230,585040803,931306322,898603490.0,32702832.0,427541383907,421520363447,204695052255.0,182318451.0,
20141017,425311288395,29063327336,28282912618.0,780414718.0,2654957393,487718729,743205694,840527768.0,-97322074.0,427966245788,422656331002,179441274958.0,295615616.0,
20141020,427824766563,23487001573,20973523405.0,2513478168.0,2824265997,537157389,748585888,699147228.0,49438660.0,430649032560,425000500566,141770458917.0,211580599.0,
20141021,430306864259,24884170638,22402072942.0,2482097696.0,2802116786,536925943,713476074,713707520.0,-231446.0,433108981045,427504747473,146567874543.0,261353010.0,
20141022,432871031115,24355603992,21791437136.0,2564166856.0,2693781267,494400773,822328450,864853620.0,-42525170.0,435564812382,430177249848,138819266837.0,157770653.0,
20141023,436985726360,25192335627,21077640382.0,4114695245.0,2340514878,408886028,817182870,902697615.0,-85514745.0,439326241238,434645211482,140911494642.0,176466757.0,
20141024,439035804092,20161466320,18111388588.0,2050077732.0,2199412318,372718592,720012033,756179469.0,-36167436.0,441235216410,436836391774,114228462028.0,193192121.0,
20141027,441744151692,20724534608,18016187008.0,2708347600.0,1996485943,332511522,799180180,839387250.0,-40207070.0,443740637635,439747665749,113571018454.0,175627721.0,
20141028,440302363994,27452149524,28893937222.0,-1441787698.0,2314768155,404811012,893030334,820730844.0,72299490.0,442617132149,437987595839,158481158439.0,224145243.0,
20141029,439652493432,37671197598,38321068160.0,-649870562.0,2611824795,479029360,943217116,868998768.0,74218348.0,442264318227,437040668637,225473194871.0,263891096.0,
20141030,443442891214,39726432779,35936034997.0,3790397782.0,2863055358,571062165,1049889692,957856887.0,92032805.0,446305946572,440579835856,226836362676.0,260857985.0,
20141031,444331032561,42922083624,42033942277.0,888141347.0,3139694050,644906244,1093918443,1020074364.0,73844079.0,447470726611,441191338511,250033120241.0,218644888.0,
20141103,449802419175,41008787115,35537400501.0,5471386614.0,3221660705,648973897,992203255,988135602.0,4067653.0,453024079880,446580758470,227731021520.0,297516784.0,
20141104,453445058673,39878215488,36235575990.0,3642639498.0,3196509968,647859142,955937193,957051948.0,-1114755.0,456641568641,450248548705,227492107976.0,228918927.0,
20141105,456679655698,35525776693,32291179668.0,3234597025.0,3175028313,650164593,935088084,932782633.0,2305451.0,459854684011,453504627385,202201492054.0,200016084.0,
20141106,460287164514,31786397981,28178889165.0,3607508816.0,3071093972,622440545,883170931,910894979.0,-27724048.0,463358258486,457216070542,179995228233.0,208693967.0,
20141107,460794750926,43096954614,42589368202.0,507586412.0,3151991170,653784032,1139240456,1107896969.0,31343487.0,463946742096,457642759756,244813681183.0,217972990.0,
20141110,464090522420,43074937834,39779166340.0,3295771494.0,3775253288,827763105,1208677572,1034698499.0,173979073.0,467865775708,460315269132,245613595440.0,256480464.0,
20141111,468511764722,59512181726,55090939424.0,4421242302.0,3677941190,800379944,1203971043,1231354204.0,-27383161.0,472189705912,464833823532,331494808915.0,367122286.0,
20141112,471792706194,38069159328,34788217856.0,3280941472.0,3882134761,832982089,1093428955,1060826810.0,32602145.0,475674840955,467910571433,216325897991.0,411233250.0,
20141113,474102238964,47038257972,44728725202.0,2309532770.0,3918633272,845053146,1089309031,1077237974.0,12071057.0,478020872236,470183605692,258552519145.0,310660107.0,
20141114,474451979124,33685785420,33336045260.0,349740160.0,3805366969,809489891,859203537,894766792.0,-35563255.0,478257346093,470646612155,194825121717.0,294144062.0,
20141117,476797912474,33657280576,31311347226.0,2345933350.0,3685735609,758355649,796147149,847281391.0,-51134242.0,480483648083,473112176865,199465229500.0,258258310.0,
20141118,479387054532,30864025290,28274883232.0,2589142058.0,3318621527,671129141,841441801,928668309.0,-87226508.0,482705676059,476068433005,175026912285.0,154416704.0,
20141119,481691069603,29457074491,27153059420.0,2304015071.0,3264178092,665399210,892735104,898465035.0,-5729931.0,484955247695,478426891511,167367617856.0,139514528.0,
20141120,483384872787,26772643084,25078839900.0,1693803184.0,3367936291,695967139,868061627,837493698.0,30567929.0,486752809078,480016936496,152386543739.0,133187563.0,
20141121,485787498700,37965320439,35562694526.0,2402625913.0,3334098780,669336273,1042151760,1068782626.0,-26630866.0,489121597480,482453399920,198561153711.0,225444934.0,
20141124,499260287798,69936096428,56463307330.0,13472789098.0,3450542062,662448084,1453456183,1460344372.0,-6888189.0,502710829860,495809745736,330218267306.0,382049033.0,
20141125,509781678532,59098287139,48576896405.0,10521390734.0,3601461778,700758902,1196315299,1158004481.0,38310818.0,513383140310,506180216754,281988133978.0,795681092.0,
20141126,518602496677,67013032917,58192214772.0,8820818145.0,3830675045,755040399,1220782039,1166500542.0,54281497.0,522433171722,514771821632,316986643766.0,477612473.0,
20141127,522913808670,67309594520,62998282527.0,4311311993.0,4099983450,805062141,1303976656,1253954914.0,50021742.0,527013792120,518813825220,339198685980.0,365849893.0,
20141128,528992449890,77397865373,71319224153.0,6078641220.0,4426133104,889100209,1491509405,1407471337.0,84038068.0,533418582994,524566316786,403177581478.0,423221941.0,
20141201,538392930415,77440824794,68040344269.0,9400480525.0,4568075249,921040710,1378086937,1346146436.0,31940501.0,542961005664,533824855166,401431257659.0,424793236.0,
20141202,545712569004,76886420448,69566781859.0,7319638589.0,4828937503,923073399,1541232526,1539199837.0,2032689.0,550541506507,540883631501,397641297504.0,341620607.0,
20141203,552052549201,99700572568,93360592371.0,6339980197.0,4791756429,903194391,1448412944,1468291952.0,-19879008.0,556844305630,547260792772,529813061035.0,453828314.0,
20141204,569429142951,105227574155,87850980405.0,17376593750.0,5252685856,941956620,1573490018,1534727789.0,38762229.0,574681828807,564176457095,509100438842.0,540231195.0,
20141205,575483801438,113474295457,107419636970.0,6054658487.0,5035049577,892615083,1540867053,1590208590.0,-49341537.0,580518851015,570448751861,639207875843.0,611697431.0,
20141208,595995563719,114513688894,94001926613.0,20511762281.0,5686867709,995831230,1709393286,1606177139.0,103216147.0,601682431428,590308696010,594309596468.0,540100631.0,
20141209,605492638583,121843297582,112346222718.0,9497074864.0,5039482033,914927637,1591762695,1672666288.0,-80903593.0,610532120616,600453156550,793170013370.0,793567612.0,
20141210,614042935191,92619534535,84069237927.0,8550296608.0,4845585561,841858350,1616220166,1689289453.0,-73069287.0,618888520752,609197349630,535679510114.0,553583669.0,
20141211,617381768756,81319089922,77980256357.0,3338833565.0,4817034195,854689464,1443866814,1431035700.0,12831114.0,622198802951,612564734561,482052634645.0,632614454.0,
20141212,619376064853,73760055817,71765759720.0,1994296097.0,4628969709,815521523,1325624254,1364792195.0,-39167941.0,624005034562,614747095144,421790738064.0,493781796.0,
20141215,628731166297,76617552763,67262451319.0,9355101444.0,4669814929,814475178,1349573360,1350619705.0,-1046345.0,633400981226,624061351368,415929261086.0,551236309.0,
20141216,637958256722,92376303515,83149213090.0,9227090425.0,4957962271,853613379,1765606520,1726468319.0,39138201.0,642916218993,633000294451,494150935815.0,411609216.0,
20141217,648449628389,105662386619,95171014952.0,10491371667.0,5036994474,865219858,1821400330,1809793851.0,11606479.0,653486622863,643412633915,582169751438.0,485245060.0,
20141218,657356997782,86108084304,77200714911.0,8907369393.0,5116335254,872698179,1566415717,1558937396.0,7478321.0,662473333036,652240662528,468018425529.0,435142509.0,
20141219,667260348402,87986460410,78083109790.0,9903350620.0,4990159015,859906608,1622112746,1634904317.0,-12791571.0,672250507417,662270189387,516637180833.0,584050968.0,
20141222,670595742509,96086844112,92751450005.0,3335394107.0,5146324106,890122025,1413056150,1382840733.0,30215417.0,675742066615,665449418403,624921521942.0,562719992.0,
20141223,669005263570,68088717135,69679196074.0,-1590478939.0,4905506876,847853767,1286459935,1328728193.0,-42268258.0,673910770446,664099756694,420787547265.0,345481248.0,
20141224,667220851499,60785434137,62569846208.0,-1784412071.0,4423264212,783877016,1386061393,1450038144.0,-63976751.0,671644115711,662797587287,379643817625.0,255733762.0,
20141225,672974233665,66548637889,60795255723.0,5753382166.0,5075978446,884652636,1692348394,1591572774.0,100775620.0,678050212111,667898255219,380302196133.0,262494073.0,
20141226,678646298701,87566428865,81894363829.0,5672065036.0,5392786771,908219276,1569099080,1545532440.0,23566640.0,684039085472,673253511930,489752059684.0,444782633.0,
20141229,687678463441,102445925919,93413761179.0,9032164740.0,5485660125,921606454,1498505294,1485118116.0,13387178.0,693164123566,682192803316,557066710829.0,522350546.0,
20141230,691781993774,76341827158,72238296825.0,4103530333.0,5620343498,956068448,1410191883,1375729889.0,34461994.0,697402337272,686161650276,438312333850.0,255163290.0,
20141231,690304859709,80629221496,82106355561.0,-1477134065.0,6213794573,1033591309,1501441714,1423918853.0,77522861.0,696518654282,684091065136,434715849009.0,284218546.0,
20150105,700007355731,102462217665,92759721643.0,9702496022.0,6127222126,998243783,1448182019,1483529545.0,-35347526.0,706134577857,693880133605,550418976350.0,451056633.0,
20150106,707391292198,98370829909,90986893442.0,7383936467.0,5990342373,972732503,1251407226,1276918506.0,-25511280.0,713381634571,701400949825,532107276995.0,380648246.0,
20150107,715729306750,81243060299,72905045747.0,8338014552.0,6161617855,999317750,1159975687,1133390440.0,26585247.0,721890924605,709567688895,437637565412.0,357440817.0,
20150108,718485280095,72365046460,69609073115.0,2755973345.0,5627589892,943391394,982279484,1038205840.0,-55926356.0,724112869987,712857690203,399192497500.0,346298356.0,
20150109,726400724109,87327038290,79411594276.0,7915444014.0,5383417787,918874498,1538413338,1562930234.0,-24516896.0,731784141896,721017306322,458848211933.0,259689096.0,
20150112,735878164519,68855556662,59378116252.0,9477440410.0,5080926118,871073168,1075613449,1123414779.0,-47801330.0,740959090637,730797238401,366520226335.0,364696528.0,
20150113,740893116001,52882711315,47867759833.0,5014951482.0,4970840174,853669905,1100244336,1117647599.0,-17403263.0,745863956175,735922275827,273875613251.0,218537733.0,
20150114,749750725573,55908600370,47050990798.0,8857609572.0,4832460055,819901731,1031836955,1065605129.0,-33768174.0,754583185628,744918265518,267380101208.0,185120013.0,
20150115,762382827637,71147906275,58515804211.0,12632102064.0,5061962503,837376405,1305319686,1287845012.0,17474674.0,767444790140,757320865134,331240784316.0,282248601.0,
20150116,766660200847,83138464387,78861091177.0,4277373210.0,5019945559,836900593,1212010371,1212486183.0,-475812.0,771680146406,761640255288,393231417065.0,234542084.0,
20150119,752047988453,72756876383,87369088777.0,-14612212394.0,4006316935,695039440,1100466344,1242327497.0,-141861153.0,756054305388,748041671518,409546218398.0,647086515.0,
20150120,750762421151,76513181618,77798748920.0,-1285567302.0,4089037320,719397938,1507143437,1482784939.0,24358498.0,754851458471,746673383831,417132405201.0,344988063.0,
20150121,754595954233,91163378655,87329845573.0,3833533082.0,4822496958,817893900,1722377359,1623881397.0,98495962.0,759418451191,749773457275,473801698525.0,326433556.0,
20150122,761668956446,75064691111,67991688898.0,7073002213.0,4785141949,816099513,973298500,975092887.0,-1794387.0,766454098395,756883814497,408419297580.0,322066630.0,
20150123,766038511313,82258662501,77889107634.0,4369554867.0,4700104444,794384758,1307260513,1328975268.0,-21714755.0,770738615757,761338406869,421041623992.0,377560071.0,
20150126,771373532853,67111894515,61776872975.0,5335021540.0,4885928763,823866912,1159453953,1129971799.0,29482154.0,776259461616,766487604090,358618512923.0,450019172.0,
20150127,773837742011,75031235777,72567026619.0,2464209158.0,4699665607,798720421,1220933535,1246080026.0,-25146491.0,778537407618,769138076404,418755090707.0,313018702.0,
20150128,775933490835,63920072891,61824324067.0,2095748824.0,4542722686,773840993,1190286348,1215165776.0,-24879428.0,780476213521,771390768149,342073089000.0,272156191.0,
20150129,777561647997,55046202356,53418045194.0,1628157162.0,4327857932,736792799,998013384,1035061578.0,-37048194.0,781889505929,773233790065,296752406555.0,268165445.0,
20150130,773977698926,50312558223,53896507294.0,-3583949071.0,4040912993,690478134,914321293,960635958.0,-46314665.0,778018611919,769936785933,284284910213.0,206486902.0,
20150202,774866786825,47632245458,46743157559.0,889087899.0,3768751438,638069320,998229174,1050637988.0,-52408814.0,778635538263,771098035387,267634578140.0,196200099.0,
20150203,773741930732,52159764433,53284620526.0,-1124856093.0,4125153312,687277595,1068524030,1019315755.0,49208275.0,777867084044,769616777420,284274307120.0,195761506.0,
20150204,774770652233,55998184225,54969462724.0,1028721501.0,4075255266,694053449,1199049654,1192273800.0,6775854.0,778845907499,770695396967,291491501665.0,262290537.0,
20150205,777970437249,70696075163,67496290147.0,3199785016.0,3951049404,675814531,1324122648,1342361566.0,-18238918.0,781921486653,774019387845,348347664791.0,279193314.0,
20150206,779641865766,51350016719,49678588202.0,1671428517.0,3355007223,564209002,1289932980,1401538509.0,-111605529.0,782996872989,776286858543,267114291144.0,226833919.0,
20150209,786747284226,51281340753,44175922293.0,7105418460.0,3292347071,552250455,1497271319,1509229866.0,-11958547.0,790039631297,783454937155,241457815758.0,171038705.0,
20150210,797891845821,49940656430,38796094835.0,11144561595.0,3321741382,547550167,1402007917,1406708205.0,-4700288.0,801213587203,794570104439,225834605954.0,160300694.0,
20150211,805111175134,49814292794,42594963481.0,7219329313.0,3376239249,552555015,1102904755,1097899907.0,5004848.0,808487414383,801734935885,223241176069.0,189207084.0,
20150212,804093283315,49061175820,50079067639.0,-1017891819.0,3307983650,533390006,982933954,1002098963.0,-19165009.0,807401266965,800785299665,231578979896.0,306749884.0,
20150213,779162373527,52535663244,77466573032.0,-24930909788.0,3311066082,529972301,962369402,965787107.0,-3417705.0,782473439609,775851307445,295682777002.0,211131112.0,
20150216,772980408663,53928574063,60110538927.0,-6181964864.0,3238037227,506514032,860489122,883947391.0,-23458269.0,776218445890,769742371436,266419822110.0,162761774.0,
20150217,753461212526,49701309648,69220505785.0,-19519196137.0,3034256889,468094316,674412666,712832382.0,-38419716.0,756495469415,750426955637,263610249013.0,269805070.0,
20150225,770968145360,60092819984,42585887150.0,17506932834.0,3277751249,522163877,819377339,765307778.0,54069561.0,774245896609,767690394111,264956284444.0,202958964.0,
20150226,778901920692,70218750802,62284975470.0,7933775332.0,3727497308,600194304,1245468190,1167437763.0,78030427.0,782629418000,775174423384,334523842866.0,221351182.0,
20150227,780843947820,67295472698,65353445570.0,1942027128.0,3643957926,578066058,906278384,928406630.0,-22128246.0,784487905746,777199989894,335266685725.0,276029154.0,
20150302,792791389697,79111411070,67163969193.0,11947441877.0,3820324241,600182396,1086852330,1064735992.0,22116338.0,796611713938,788971065456,411426132506.0,365731311.0,
20150303,804100125942,87283032063,75974295818.0,11308736245.0,3658347664,561490657,1188200050,1226891789.0,-38691739.0,807758473606,800441778278,442237857929.0,436398773.0,
20150304,811253368861,66225246334,59072003415.0,7153242919.0,3800138283,590422635,1108455680,1079523702.0,28931978.0,815053507144,807453230578,349824594837.0,296604686.0,
20150305,819402239652,70255155893,62106285102.0,8148870791.0,3596427868,558295958,1277060227,1309186904.0,-32126677.0,822998667520,815805811784,374675077773.0,271949243.0,
20150306,824379989028,61530416037,56552666661.0,4977749376.0,3441280015,529268837,1400398864,1429425985.0,-29027121.0,827821269043,820938709013,330404657961.0,282554943.0,
20150309,834878753182,70291104924,59792340770.0,10498764154.0,3353984453,520205890,1878488806,1887551753.0,-9062947.0,838232737635,831524768729,360858512297.0,273692101.0,
20150310,848537789505,68915727800,55256691477.0,13659036323.0,3099078967,505009170,1633891332,1649088052.0,-15196720.0,851636868472,845438710538,332610012713.0,266367141.0,
20150311,864004113742,65924942057,50458617820.0,15466324237.0,2927592012,458202242,1480830901,1527637829.0,-46806928.0,866931705754,861076521730,328433721178.0,266184522.0,
20150312,878075844620,85412099181,71340368303.0,14071730878.0,3182040688,495994833,1862531473,1824738882.0,37792591.0,881257885308,874893803932,408183756156.0,383711024.0,
20150313,880611781488,76456008406,73920071538.0,2535936868.0,3193989076,492300090,1428684781,1432379524.0,-3694743.0,883805770564,877417792412,374707044594.0,298384601.0,
20150316,874850559115,93488482835,99249705208.0,-5761222373.0,3535076305,529826432,1466225810,1428699468.0,37526342.0,878385635420,871315482810,480449245354.0,468848978.0,
20150317,881882625541,118453665965,111421599539.0,7032066426.0,3731158044,556521021,1950507069,1923812480.0,26694589.0,885613783585,878151467497,602021031730.0,525409790.0,
20150318,896108504027,123253353097,109027474611.0,14225878486.0,4223177943,627925841,2044008241,1972603421.0,71404820.0,900331681970,891885326084,617953856828.0,391190740.0,
20150319,911756727783,119422295098,103774071342.0,15648223756.0,4136003055,614805850,1602861352,1615981343.0,-13119991.0,915892730838,907620724728,613929349598.0,362047996.0,
20150320,927002173004,133491591365,118246146144.0,15245445221.0,4317418963,657654705,1858440114,1815591259.0,42848855.0,931319591967,922684754041,654023492621.0,389697337.0,
20150323,935961490802,122350894415,113391576617.0,8959317798.0,4789023959,732427324,1690085064,1615312445.0,74772619.0,940750514761,931172466843,662711518950.0,567378120.0,
20150324,948928112150,145585328346,132618706998.0,12966621348.0,4619080288,689082182,1829457216,1872802358.0,-43345142.0,953547192438,944309031862,757933817500.0,563220561.0,
20150325,960086790787,115371500560,104212821923.0,11158678637.0,4643215819,698297120,1524507026,1515292088.0,9214938.0,964730006606,955443574968,646139743972.0,422973319.0,
20150326,971529344684,117308029200,105865475303.0,11442553897.0,4759646631,717948665,1763608907,1743957362.0,19651545.0,976288991315,966769698053,619276086871.0,574182354.0,
20150327,974695451811,94331337806,91165230679.0,3166107127.0,4882309085,742424285,1661692649,1637217029.0,24475620.0,979577760896,969813142726,509743657807.0,402379641.0,
20150330,987305162447,128248977117,115639266481.0,12609710636.0,5489035498,840090452,2127987302,2030321135.0,97666167.0,992794197945,981816126949,693387162009.0,503831930.0,
20150331,992114591127,116775077460,111965648780.0,4809428680.0,5408130188,815494453,1326090630,1350686629.0,-24595999.0,997522721315,986706460939,722223779944.0,429103379.0,
20150401,1007500876332,112637594862,97251309657.0,15386285205.0,5579432794,839075487,1729479501,1705898467.0,23581034.0,1013080309126,1001921443538,594208886582.0,353268554.0,
20150402,1019832320645,122445942102,110114497789.0,12331444313.0,5605667753,845035143,1548304018,1542344362.0,5959656.0,1025437988398,1014226652892,633076710347.0,428392218.0,
20150403,1028339497560,121745692024,113238515109.0,8507176915.0,5639393066,833666811,1685019881,1696388213.0,-11368332.0,1033978890626,1022700104494,636898437602.0,436133692.0,
20150407,1049019510305,135205459177,114525446432.0,20680012745.0,6052607373,890246879,1812376621,1755796553.0,56580068.0,1055072117678,1042966902932,748067747418.0,439395492.0,
20150408,1063907515309,146795417745,131907412741.0,14888005004.0,6090844298,883306430,1811107279,1818047728.0,-6940449.0,1069998359607,1057816671011,840743977683.0,588148496.0,
20150409,1080032082669,151266260607,135141693247.0,16124567360.0,7459280657,950252465,1839296323,1772350288.0,66946035.0,1087491363326,1072572802012,818442737912.0,782086537.0,
20150410,1093646777627,120171575492,106556880534.0,13614694958.0,6013790547,851628036,1903813388,2002437817.0,-98624429.0,1099660568174,1087632987080,670612250853.0,1359825754.0,
20150413,1112644681454,125462079457,106464175630.0,18997903827.0,6012263982,837423227,1717712021,1731916830.0,-14204809.0,1118656945436,1106632417472,786522867861.0,303145664.0,
20150414,1132444514795,135681414792,115881581451.0,19799833341.0,5734278801,808065982,2105259947,2134617192.0,-29357245.0,1138178793596,1126710235994,811293129035.0,4641180085.0,
20150415,1146127306376,127637503244,113954711663.0,13682791581.0,5760511452,815236850,2243634120,2236463252.0,7170868.0,1151887817828,1140366794924,772877764568.0,2332011990.0,
20150416,1157182044282,112006268973,100951531067.0,11054737906.0,5973347250,820992013,2203963301,2198208138.0,5755163.0,1163155391532,1151208697032,711415682314.0,1802180686.0,
20150417,1149157713135,129211438621,137235769768.0,-8024331147.0,6041055352,819750253,1380227173,1381468933.0,-1241760.0,1155198768487,1143116657783,916104719138.0,1734333010.0,
20150420,1143069525623,165794251895,171882439407.0,-6088187512.0,5886540287,806776144,1954779241,1967753350.0,-12974109.0,1148956065910,1137182985336,1147629237929.0,1683813595.0,
20150421,1153574815097,143192898510,132687609036.0,10505289474.0,5961506282,800532646,1946106430,1952349928.0,-6243498.0,1159536321379,1147613308815,863828254503.0,1018530603.0,
20150422,1172665362874,165509139277,146418591500.0,19090547777.0,6368406198,841589251,2106225741,2065169136.0,41056605.0,1179033769072,1166296956676,977531423485.0,1117422617.0,
20150423,1185643651435,171737823864,158759535303.0,12978288561.0,6278465187,839707386,2013411225,2015293090.0,-1881865.0,1191922116622,1179365186248,965905869789.0,1027044615.0,
20150424,1192302971884,153156908610,146497588161.0,6659320449.0,5965256427,793270872,1641802815,1688239329.0,-46436514.0,1198268228311,1186337715457,917924009447.0,1118670830.0,
20150427,1210543730393,162760454052,144519695543.0,18240758509.0,6254062725,829882223,1970873725,1934262374.0,36611351.0,1216797793118,1204289667668,980734490757.0,1004779499.0,
20150428,1215607398598,148772163843,143708495638.0,5063668205.0,6149727519,818516118,2090163995,2101530100.0,-11366105.0,1221757126117,1209457671079,1062486914630.0,1206888721.0,
20150429,1221406603476,126739953108,120940748230.0,5799204878.0,6021609553,794875454,1887770640,1911411304.0,-23640664.0,1227428213029,1215384993923,752375899014.0,907690777.0,
20150430,1224334129835,135754031359,132826505000.0,2927526359.0,5831675719,783508407,1749354418,1760721465.0,-11367047.0,1230165805554,1218502454116,774874855635.0,1104657363.0,
20150504,1241303319482,116900666542,99931476895.0,16969189647.0,5999922775,821124336,1694089441,1656473512.0,37615929.0,1247303242257,1235303396707,719619875445.0,1126560234.0,
20150505,1244231572418,128460864619,125532611683.0,2928252936.0,4992896354,692133030,1724892827,1853884133.0,-128991306.0,1249224468772,1239238676064,804976732193.0,1131916196.0,
20150506,1258820234374,122153633570,107564971614.0,14588661956.0,4701559723,647179937,1579163978,1624117071.0,-44953093.0,1263521794097,1254118674651,716458293481.0,1086774537.0,
20150507,1265872162917,94358842320,87306913777.0,7051928543.0,4030097633,528167454,1586470622,1705483105.0,-119012483.0,1269902260550,1261842065284,539925860103.0,1258457261.0,
20150508,1245786699057,87812628024,107898091884.0,-20085463860.0,4135054341,536002927,1669321134,1661485661.0,7835473.0,1249921753398,1241651644716,560295160872.0,834508429.0,
20150511,1247505935416,119726264827,118007028468.0,1719236359.0,4834763087,628804192,2141547740,2048746475.0,92801265.0,1252340698503,1242671172329,714882314940.0,1425663083.0,
20150512,1256607720425,136448970581,127347185572.0,9101785009.0,5319748801,707971746,2148465499,2069297945.0,79167554.0,1261927469226,1251287971624,794492584976.0,1437159691.0,
20150513,1265406189486,132209749584,123411280523.0,8798469061.0,5472339769,744973638,1836400568,1799398676.0,37001892.0,1270878529255,1259933849717,797081030986.0,1296544600.0,
20150514,1271467867961,105312775966,99251097491.0,6061678475.0,5402256675,727304965,1732086628,1749755301.0,-17668673.0,1276870124636,1266065611286,670745528376.0,1419673187.0,
20150515,1270378616254,103539242662,104628494369.0,-1089251707.0,4746218114,622531450,1692384011,1797157526.0,-104773515.0,1275124834368,1265632398140,665079555869.0,2240716555.0,
20150518,1278951775452,95383811648,86810652450.0,8573159198.0,4622251110,619939863,1578107544,1580699131.0,-2591587.0,1283574026562,1274329524342,593452865752.0,2355758833.0,
20150519,1294245193796,113575243435,98281825091.0,15293418344.0,4763472053,614797160,2008707627,2013850330.0,-5142703.0,1299008665849,1289481721743,694208347298.0,2135916110.0,
20150520,1310006880147,117098266840,101336580489.0,15761686351.0,4656256937,601080316,1687963151,1701679995.0,-13716844.0,1314663137084,1305350623210,806196898780.0,2283728467.0,
20150521,1321176723760,108553228977,97383385364.0,11169843613.0,4925644941,634903922,1303497207,1269673601.0,33823606.0,1326102368701,1316251078819,729532561002.0,1945119362.0,
20150522,1314567656582,142752614727,149361681905.0,-6609067178.0,5329555085,665671261,1773361484,1742594145.0,30767339.0,1319897211667,1309238101497,1007134180736.0,2558537172.0,
20150525,1318998299726,164145678044,159715034900.0,4430643144.0,6190475546,745828808,1748595767,1668438220.0,80157547.0,1325188775272,1312807824180,1081463353305.0,1780995506.0,
20150526,1329561906147,159094373511,148530767090.0,10563606421.0,6488280901,769896709,1505908324,1481840423.0,24067901.0,1336050187048,1323073625246,1142757761220.0,2193939500.0,
20150527,1336990097550,126358447704,118930256301.0,7428191403.0,6425385136,751439850,1230064283,1248521142.0,-18456859.0,1343415482686,1330564712414,1116800143964.0,2019940243.0,
20150528,1345459596439,161711190822,153241691933.0,8469498889.0,5430216405,653062958,1479510294,1577887186.0,-98376892.0,1350889812844,1340029380034,1246366952799.0,2500122697.0,
20150529,1348287000435,109545698973,106718294977.0,2827403996.0,4975685928,591895544,1535238736,1596406150.0,-61167414.0,1353262686363,1343311314507,954356499929.0,2227577821.0,
20150601,1367127995718,117887770661,99046775378.0,18840995283.0,5237617260,627008827,1888828181,1853714898.0,35113283.0,1372365612978,1361890378458,935153818254.0,2099379420.0,
20150602,1387882217728,133758105973,113003883963.0,20754222010.0,5040510626,608826462,1787608851,1805791216.0,-18182365.0,1392922728354,1382841707102,998954439925.0,2245938460.0,
20150603,1402927079454,119037456520,103992594794.0,15044861726.0,4894947220,593948327,1550105851,1564983986.0,-14878135.0,1407822026674,1398032132234,1011069423856.0,1979480435.0,
20150604,1412300874405,140960563937,131586768986.0,9373794951.0,4894445720,594151113,2091611178,2091408392.0,202786.0,1417195320125,1407406428685,1051733717317.0,2753691837.0,
20150605,1412610800411,162459513338,162149587332.0,309926006.0,5196658863,626982856,1397258933,1364427190.0,32831743.0,1417807459274,1407414141548,1232528230853.0,1971722819.0,
20150608,1419155431830,175635531492,169090900073.0,6544631419.0,6066372273,706327864,2153296135,2073951127.0,79345008.0,1425221804103,1413089059557,1308047464205.0,2740228980.0,
20150609,1428637577543,147185167674,137703021961.0,9482145713.0,5856847970,692502719,1866304046,1880129191.0,-13825145.0,1434494425513,1422780729573,1152322144740.0,1670056351.0,
20150610,1436953511811,132102202755,123786268487.0,8315934268.0,5922838027,682946816,1776050760,1785606663.0,-9555903.0,1442876349838,1431030673784,1007550519585.0,1563706094.0,
20150611,1443868735753,132745195582,125829971640.0,6915223942.0,6044144042,735640495,1564930174,1512236495.0,52693679.0,1449912879795,1437824591711,976213186528.0,1217036549.0,
20150612,1453579989204,140782088205,131070834754.0,9711253451.0,6017861873,734805206,1829689029,1830524318.0,-835289.0,1459597851077,1447562127331,1060380026999.0,1768982880.0,
20150615,1460771548784,139727644688,132536085108.0,7191559580.0,5678984181,714394315,1683932637,1704343528.0,-20410891.0,1466450532965,1455092564603,1065534298762.0,1277936492.0,
20150616,1463951216264,110467806485,107288139005.0,3179667480.0,5010413917,651077472,1376855849,1440172692.0,-63316843.0,1468961630181,1458940802347,897266334838.0,1407242751.0,
20150617,1475103559271,108881795164,97729452157.0,11152343007.0,4411760221,528983150,2174586687,2296681009.0,-122094322.0,1479515319492,1470691799050,829069378816.0,1715933325.0,
20150618,1482910960306,102883459843,95076058808.0,7807401035.0,4003390202,490123431,1732961716,1771821435.0,-38859719.0,1486914350508,1478907570104,786090819811.0,1184808612.0,
20150619,1479299517720,93916444426,97527887012.0,-3611442586.0,3056543634,381455997,1576419073,1685086507.0,-108667434.0,1482356061354,1476242974086,684178191423.0,1557607796.0,
20150623,1468845650070,71923409449,82377277099.0,-10453867650.0,3262509775,394954446,1354114297,1340615848.0,13498449.0,1472108159845,1465583140295,692962191478.0,1710362116.0,
20150624,1439971876069,99110730843,127984504844.0,-28873774001.0,3870183220,467537982,1833444664,1760861128.0,72583536.0,1443842059289,1436101692849,814848975294.0,1255105566.0,
20150625,1423248786555,112543339631,129266429145.0,-16723089514.0,4077042981,526175532,1904698270,1846060720.0,58637550.0,1427325829536,1419171743574,865323794527.0,1274281279.0,
20150626,1387049624743,97236522159,133435683971.0,-36199161812.0,3047418280,420715654,2085715999,2191175877.0,-105459878.0,1390097043023,1384002206463,786141973872.0,1908103018.0,
20150629,1360422100831,111777711829,138405235741.0,-26627523912.0,2869439317,447069571,2590020801,2563666884.0,26353917.0,1363291540148,1357552661514,903723067077.0,1920716912.0,
20150630,1335503814173,111609532061,136527818719.0,-24918286658.0,2962511878,399448299,2611587657,2659208929.0,-47621272.0,1338466326051,1332541302295,940234665803.0,1980693812.0,
20150701,1328818572775,102412410526,109097651924.0,-6685241398.0,3032047503,446136047,2191541832,2144854084.0,46687748.0,1331850620278,1325786525272,837733126367.0,1506836620.0,
20150702,1293827661966,88487618099,123478528908.0,-34990910809.0,2509128299,361945765,2453422624,2537612906.0,-84190282.0,1296336790265,1291318533667,735125948858.0,1509219982.0,
20150703,1244976682669,75761353558,124612332855.0,-48850979297.0,1946060586,291951070,1195700702,1265695397.0,-69994695.0,1246922743255,1243030622083,646562405984.0,2029099847.0,
20150706,1151409843974,86253165993,179820004688.0,-93566838695.0,1913867669,272593963,280953116,300310223.0,-19357107.0,1153323711643,1149495976305,941578115403.0,2032169052.0,
20150707,1053097367290,65565705505,163878182189.0,-98312476684.0,1858251281,272716395,209434967,209312535.0,122432.0,1054955618571,1051239116009,775437835701.0,939411710.0,
20150708,940870474994,40122005740,152348898036.0,-112226892296.0,1621043791,263508669,126455954,135663680.0,-9207726.0,942491518785,939249431203,700211321864.0,397753234.0,
20150709,927849404820,85033177459,98054247633.0,-13021070174.0,1692753289,264901325,129269092,127876436.0,1392656.0,929542158109,926156651531,672022615147.0,1392260174.0,
20150710,932305971025,99007475226,94550909021.0,4456566205.0,1763754984,253333446,136284948,147852827.0,-11567879.0,934069726009,930542216041,679737840614.0,1094047317.0,
20150713,934271207261,108699727868,106734491632.0,1965236236.0,1857208347,272290354,142599558,123642650.0,18956908.0,936128415608,932413998914,780962116421.0,1813211670.0,
20150714,936754623345,112517508100,110034092016.0,2483416084.0,1835725241,286888194,156604000,142006160.0,14597840.0,938590348586,934918898104,828551515478.0,1666454811.0,
20150715,920524732197,87450742190,103680633338.0,-16229891148.0,1834758822,293027310,307415748,301276632.0,6139116.0,922359491019,918689973375,699381004735.0,1287266302.0,
20150716,918396130560,75364896359,77493497996.0,-2128601637.0,1774737334,288475352,295156145,299708103.0,-4551958.0,920170867894,916621393226,568875445894.0,1071157416.0,
20150717,921338704319,88919851672,85977277913.0,2942573759.0,1822969650,283823973,289434379,294085758.0,-4651379.0,923161673969,919515734669,592080251170.0,1106772964.0,
20150720,921348386943,94950968728,94941286104.0,9682624.0,2193555412,355248393,430413418,358988998.0,71424420.0,923541942355,919154831531,687799666788.0,1003178460.0,
20150721,928615710814,95165466241,87898142370.0,7267323871.0,2335036599,378307958,431586479,408526914.0,23059565.0,930950747413,926280674215,645965105824.0,666208055.0,
20150722,928881478891,94378343848,94112575771.0,265768077.0,2361120493,385666185,517651117,510292890.0,7358227.0,931242599384,926520358398,679177553030.0,708006014.0,
20150723,941369680547,109984949964,97496748308.0,12488201656.0,2262926970,370551723,597044652,612159114.0,-15114462.0,943632607517,939106753577,742766807170.0,894155455.0,
20150724,940822832963,121558351199,122105198783.0,-546847584.0,2342381838,396426559,802224078,776349242.0,25874836.0,943165214801,938480451125,842247475226.0,1035546923.0,
20150727,919373759165,91115117073,112564190871.0,-21449073798.0,2140343412,402985425,805299888,798741022.0,6558866.0,921514102577,917233415753,720366199626.0,1116193843.0,
20150728,887462793572,69518139535,101429105128.0,-31910965593.0,2041011444,372369603,668174860,698790682.0,-30615822.0,889503805016,885421782128,683802828832.0,1311955503.0,
20150729,881733008327,71228735424,76958520669.0,-5729785245.0,2204435202,399846272,768767663,741290994.0,27476669.0,883937443529,879528573125,556503669931.0,991805182.0,
20150730,881652186879,82706905549,82787726997.0,-80821448.0,2241704283,431124222,697464218,666186268.0,31277950.0,883893891162,879410482596,615061642188.0,950051881.0,
20150731,859970601967,50034690518,71716275430.0,-21681584912.0,2232410006,431901758,490047392,489269856.0,777536.0,862203011973,857738191961,462683444149.0,657377382.0,
20150803,832475432082,41851431424,69346601309.0,-27495169885.0,2491448013,481095430,344467544,295273872.0,49193672.0,834966880095,829983984069,445186094624.0,805498851.0,
20150804,842108030431,60977446773,51344848424.0,9632598349.0,2611179954,477989807,20185344,23290967.0,-3105623.0,844719210385,839496850477,463284611450.0,787065232.0,
20150805,842301741836,63096752525,62903041120.0,193711405.0,2511051535,472649945,8743388,14083250.0,-5339862.0,844812793371,839790690301,483223555423.0,659336967.0,
20150806,839838718760,46010651060,48473674136.0,-2463023076.0,2453501723,466095533,9671800,16226212.0,-6554412.0,842292220483,837385217037,357387461125.0,402298394.0,
20150807,845629259242,63254755083,57464214601.0,5790540482.0,2148973829,396348385,5112403,74859551.0,-69747148.0,847778233071,843480285413,445224680689.0,727980321.0,
20150810,861223721255,98653015518,83058553505.0,15594462013.0,2386249912,420358094,35050560,11040851.0,24009709.0,863609971167,858837471343,652168746261.0,1011252047.0,
20150811,870103319713,104695193380,95815594922.0,8879598458.0,2286113685,416370751,16105307,20092650.0,-3987343.0,872389433398,867817206028,711724610255.0,941708973.0,
20150812,873794479627,84189224771,80498064857.0,3691159914.0,2402549957,437869763,33045600,11546588.0,21499012.0,876197029584,871391929670,596452424739.0,935223519.0,
20150813,882774372393,86857774356,77877881590.0,8979892766.0,2351486477,430766284,30547700,37651179.0,-7103479.0,885125858870,880422885916,577893189501.0,850439807.0,
20150814,886085989804,94821464981,91509847570.0,3311617411.0,2238103960,378537615,32101979,84330648.0,-52228669.0,888324093764,883847885844,646741744374.0,862252946.0,
20150817,894506794785,93341898906,84921093925.0,8420804981.0,2483435259,405085221,55929141,29381535.0,26547606.0,896990230044,892023359526,626320880423.0,731434236.0,
20150818,879899884284,99199001573,113805912074.0,-14606910501.0,2533802842,424822078,66503798,46766941.0,19736857.0,882433687126,877366081442,721479863878.0,1084544452.0,
20150819,875442817227,81247402297,85704469354.0,-4457067057.0,2367304973,405080751,60862980,80604307.0,-19741327.0,877810122200,873075512254,599105757117.0,967581058.0,
20150820,869228227066,67585656067,73800246228.0,-6214590161.0,2358282923,399200479,42621897,48502169.0,-5880272.0,871586509989,866869944143,507140336399.0,607597323.0,
20150821,848630862572,51673986450,72271350944.0,-20597364494.0,2195223661,381279185,44073116,61994410.0,-17921294.0,850826086233,846435638911,455318600934.0,785116042.0,
20150824,795943105071,38245805551,90933563052.0,-52687757501.0,2004816456,391807060,60377862,49849987.0,10527875.0,797947921527,793938288615,359691016668.0,933634968.0,
20150825,740536035623,38055426386,93462495834.0,-55407069448.0,1871872598,397121654,57083825,51769231.0,5314594.0,742407908221,738664163025,359871270297.0,1137074067.0,
20150826,706522058254,49181259228,83195236597.0,-34013977369.0,1942973253,405021453,39309111,31409312.0,7899799.0,708465031507,704579085001,461050093545.0,1033383627.0,
20150827,685022556433,45681104014,67180605835.0,-21499501821.0,2124421074,444885202,68989700,29125951.0,39863749.0,687146977507,682898135359,403688860920.0,686909892.0,
20150828,683118490904,59881095450,61785160979.0,-1904065529.0,2206833724,410690598,27151623,61346227.0,-34194604.0,685325324628,680911657180,474112965367.0,807674246.0,
20150831,673127713583,49354997209,59345774530.0,-9990777321.0,2312390948,438264408,46944193,19370383.0,27573810.0,675440104531,670815322635,430704972975.0,518357236.0,
20150901,642834471301,37495050672,67788292954.0,-30293242282.0,2242361038,418349037,23722684,43638055.0,-19915371.0,645076832339,640592110263,420365872537.0,527151407.0,
20150902,606266170176,31013732169,67582033294.0,-36568301125.0,2217686789,417710441,18465787,19104383.0,-638596.0,608483856965,604048483387,422799952883.0,536298897.0,
20150907,615872695111,42713833063,33107308128.0,9606524935.0,2180453879,421182250,18633460,15161651.0,3471809.0,618053148990,613692241232,302433011974.0,452111337.0,
20150908,613326503591,32848347074,35394538594.0,-2546191520.0,2294014252,424435597,25730004,22476657.0,3253347.0,615620517843,611032489339,263513236416.0,532312151.0,
20150909,622302002741,56720402464,47744903314.0,8975499150.0,2290625741,417691860,22264550,29008287.0,-6743737.0,624592628482,620011377000,412950935947.0,806941611.0,
20150910,619885682685,35958226095,38374546151.0,-2416320056.0,2279414099,421792143,24070525,19970242.0,4100283.0,622165096784,617606268586,299149258535.0,515997327.0,
20150911,618850315756,32940214326,33975581255.0,-1035366929.0,2152125434,410790112,13731927,24733958.0,-11002031.0,621002441190,616698190322,252400157338.0,538589839.0,
20150914,599879253495,38443650467,57414712728.0,-18971062261.0,2148978177,420568640,26778906,17000378.0,9778528.0,602028231672,597730275318,372884874575.0,766554369.0,
20150915,587114144804,26800136447,39565245138.0,-12765108691.0,2037093535,416115086,15951066,20404620.0,-4453554.0,589151238339,585077051269,243832150756.0,450262550.0,
20150916,588177192339,36654734196,35591686661.0,1063047535.0,2076672895,403119490,15983035,28978631.0,-12995596.0,590253865234,586100519444,281443943008.0,624122881.0,
20150917,590467294488,45357176136,43067073987.0,2290102149.0,2013711808,400378022,15327924,18069392.0,-2741468.0,592481006296,588453582680,337067792496.0,610807721.0,
20150918,588929671900,27492470550,29030093138.0,-1537622588.0,2025406214,397227742,8837480,11987760.0,-3150280.0,590955078114,586904265686,218145536809.0,504531368.0,
20150921,589611425721,32786118443,32104364622.0,681753821.0,2059120123,395252238,9537520,11513024.0,-1975504.0,591670545844,587552305598,259727221968.0,552494332.0,
20150922,590105583869,39312342594,38818184446.0,494158148.0,2082180629,396046839,9943300,9148699.0,794601.0,592187764498,588023403240,304866864231.0,454636183.0,
20150923,588155766896,31571539567,33521356540.0,-1949816973.0,2021242749,393064710,8809288,11791417.0,-2982129.0,590177009645,586134524147,257169169611.0,475155418.0,
20150924,588059276593,29077086812,29173577115.0,-96490303.0,2052014070,396396967,9860961,6528704.0,3332257.0,590111290663,586007262523,231166488684.0,316629378.0,
20150925,579163991185,28658919129,37554204537.0,-8895285408.0,2003971580,396562589,9271541,9105919.0,165622.0,581167962765,577160019605,248616974619.0,374955451.0,
20150928,578137194581,20771544015,21798340619.0,-1026796604.0,2037096084,402863318,12470521,6169792.0,6300729.0,580174290665,576100098497,166373082797.0,226721717.0,
20150929,573430370272,19494241880,24201066189.0,-4706824309.0,1945833567,395762758,12445887,19546447.0,-7100560.0,575376203839,571484536705,169616202055.0,288534718.0,
20150930,565107689421,16667737149,24990418000.0,-8322680851.0,1870766950,383111420,6144567,18795905.0,-12651338.0,566978456371,563236922471,156513065294.0,227697761.0,
20151008,573423934505,38105508897,29789263813.0,8316245084.0,2010065774,390126838,12684959,5669541.0,7015418.0,575434000279,571413868731,258745888412.0,544043663.0,
20151009,573834927910,34773511196,34362517791.0,410993405.0,2021609337,392219396,14676064,12583506.0,2092558.0,575856537247,571813318573,256182757894.0,383180980.0,
20151012,590826463139,66079680740,49088145511.0,16991535229.0,2062409620,385880309,16875892,23214979.0,-6339087.0,592888872759,588764053519,434903843831.0,982846351.0,
20151013,592359492869,46417951657,44884921927.0,1533029730.0,2051103491,384657890,12068699,13291118.0,-1222419.0,594410596360,590308389378,334765236170.0,618819808.0,
20151014,595465800492,47314578853,44208271230.0,3106307623.0,2049097950,388244607,17526826,13940109.0,3586717.0,597514898442,593416702542,329794368080.0,557257890.0,
20151015,600862476185,55174519045,49777843352.0,5396675693.0,2088067241,383678231,18192543,22758919.0,-4566376.0,602950543426,598774408944,362564609626.0,708900322.0,
20151016,602483217134,67307333866,65686592917.0,1620740949.0,2040780928,364342531,14634022,33969722.0,-19335700.0,604523998062,600442436206,461111110101.0,988751720.0,
20151019,608423367347,66704231174,60764080961.0,5940150213.0,2061897151,371370016,17272456,10244971.0,7027485.0,610485264498,606361470196,452801634905.0,810079898.0,
20151020,614565648086,57331561590,51189280851.0,6142280739.0,2093241125,376760079,15975774,10585711.0,5390063.0,616658889211,612472406961,383197806906.0,696862831.0,
20151021,609597972675,75043684698,80011360109.0,-4967675411.0,2036721856,377978484,21703255,20484850.0,1218405.0,611634694531,607561250819,517783508409.0,1079733780.0,
20151022,614855939334,56765942023,51507975364.0,5257966659.0,2034048338,370468855,14514477,22024106.0,-7509629.0,616889987672,612821890996,374851019676.0,811728993.0,
20151023,618715633159,64264021721,60404327896.0,3859693825.0,2046744342,367394423,10908942,13983374.0,-3074432.0,620762377501,616668888817,424905012839.0,966765135.0,
20151026,625445402262,71288228506,64558459403.0,6729769103.0,2039335651,367271524,10104146,10227045.0,-122899.0,627484737913,623406066611,453316439238.0,862208685.0,
20151027,628033239007,61805047765,59217211020.0,2587836745.0,2051580154,369466382,10231694,8036836.0,2194858.0,630084819161,625981658853,408154635560.0,879792652.0,
20151028,625971542441,51781988858,53843685424.0,-2061696566.0,2068703219,380712918,19354621,8108085.0,11246536.0,628040245660,623902839222,361232798828.0,556613196.0,
20151029,628413061152,41575064417,39133545706.0,2441518711.0,2016767500,368158409,8236652,20791161.0,-12554509.0,630429828652,626396293652,293935236167.0,660408390.0,
20151030,626861304247,46046145880,47597902785.0,-1551756905.0,1984153934,362957410,10749359,15950358.0,-5200999.0,628845458181,624877150313,306308222401.0,1255867624.0,
20151102,624580223050,39182710955,41463792152.0,-2281081197.0,1976302866,371177740,17635200,9414870.0,8220330.0,626556525916,622603920184,284764251592.0,1541545574.0,
20151103,624641794601,32485266484,32423694933.0,61571551.0,1955303083,365526279,13980500,19631961.0,-5651461.0,626597097684,622686491518,243974550219.0,478924396.0,
20151104,636455607760,71377497141,59563683982.0,11813813159.0,2047299675,363955809,25119007,26689477.0,-1570470.0,638502907435,634408308085,425529698905.0,948963922.0,
20151105,648756449213,116126616192,103825774739.0,12300841453.0,2064814208,359542968,22044639,26457480.0,-4412841.0,650821263421,646691635005,678078372945.0,878660508.0,
20151106,657355073852,96065908261,87467283622.0,8598624639.0,2093561252,361556937,21716435,19702466.0,2013969.0,659448635104,655261512600,543221789016.0,670954970.0,
20151109,678846032704,114272067940,92781109088.0,21490958852.0,2153097052,372673657,29373118,18256398.0,11116720.0,680999129756,676692935652,635731259876.0,983714983.0,
20151110,692849446365,103276201336,89272787675.0,14003413661.0,2130119832,371208287,18309865,19775235.0,-1465370.0,694979566197,690719326533,559574799648.0,766801520.0,
20151111,698588480945,81460138173,75721103593.0,5739034580.0,2105019973,367078322,13686632,17816597.0,-4129965.0,700693500918,696483460972,467509528683.0,675408027.0,
20151112,704264669504,79386000166,73709811607.0,5676188559.0,2136717070,372418079,20899004,15559247.0,5339757.0,706401386574,702127952434,483195629656.0,798966103.0,
20151113,704017531196,76119157073,76366295381.0,-247138308.0,2161492893,376682738,28225311,23960652.0,4264659.0,706179024089,701856038303,467961364608.0,1131704880.0,
20151116,709765973662,59783115668,54034673202.0,5748442466.0,2178454674,377786256,25881903,24778385.0,1103518.0,711944428336,707587518988,368726512372.0,810087764.0,
20151117,719146385419,90257897879,80877486122.0,9380411757.0,2208478503,381601346,23878676,20063586.0,3815090.0,721354863922,716937906916,520928159522.0,971741907.0,
20151118,718128393345,61645301015,62663293089.0,-1017992074.0,2182866762,384979790,26764655,23386211.0,3378444.0,720311260107,715945526583,392310351658.0,675435291.0,
20151119,723677944809,53377151926,47827600462.0,5549551464.0,2155202427,372174144,14272579,27078225.0,-12805646.0,725833147236,721522742382,328464910760.0,773134558.0,
20151120,727483864902,67868870592,64062950499.0,3805920093.0,2178878860,377815849,22640171,16998466.0,5641705.0,729662743762,725304986042,414395797982.0,738574767.0,
20151123,724944067772,56462012238,59001809368.0,-2539797130.0,2170416716,374923464,20020203,22912588.0,-2892385.0,727114484488,722773651056,414590707351.0,797467969.0,
20151124,724356454195,41952155661,42539769238.0,-587613577.0,2168170720,375998490,18347650,17272624.0,1075026.0,726524624915,722188283475,327627058769.0,487599992.0,
20151125,722871325612,50585918649,52071047232.0,-1485128583.0,2175357594,372479695,20468421,23987216.0,-3518795.0,725046683206,720695968018,380474254755.0,849218260.0,
20151126,721562735545,57063284399,58371874466.0,-1308590067.0,2215328433,372526076,24195577,24149196.0,46381.0,723778063978,719347407112,425875158644.0,688710624.0,
20151127,707571655449,56361735197,70352815293.0,-13991080096.0,2061163221,376670438,37988666,33844304.0,4144362.0,709632818670,705510492228,463289761114.0,1163021828.0,
20151130,705712846824,47647190662,49505999287.0,-1858808625.0,2023533716,371883683,33414645,38201400.0,-4786755.0,707736380540,703689313108,385666851809.0,2241863653.0,
20151201,707573181220,41187948449,39327614053.0,1860334396.0,2077790582,373033872,30813241,29663052.0,1150189.0,709650971802,705495390638,329346008115.0,1785914230.0,
20151202,705719889489,50746609725,52599901456.0,-1853291731.0,2186265522,378148759,33975876,28860989.0,5114887.0,707906155011,703533623967,368568285565.0,909717382.0,
20151203,701215140017,45460715372,49965464844.0,-4504749472.0,2150847061,376325461,30091638,31914936.0,-1823298.0,703365987078,699064292956,338397213559.0,817932740.0,
20151204,689229679014,36130370822,48115831825.0,-11985461003.0,2100381786,377744415,27582238,26163284.0,1418954.0,691330060800,687129297228,318989716457.0,921195611.0,
20151207,688643130171,34763101101,35349649944.0,-586548843.0,2149554072,385234259,25501351,18011507.0,7489844.0,690792684243,686493576099,284560989595.0,1157479469.0,
20151208,683538869003,34153742415,39258003583.0,-5104261168.0,2148104647,393814894,32121694,23541059.0,8580635.0,685686973650,681390764356,297435370841.0,1037042492.0,
20151209,681876332446,31912185019,33574721576.0,-1662536557.0,2123493880,390034517,23454107,27234484.0,-3780377.0,683999826326,679752838566,266934578753.0,1263167676.0,
20151210,680181466516,33681721847,35376587777.0,-1694865930.0,2141678490,393550719,28977892,25461690.0,3516202.0,682323145006,678039788026,278346167537.0,1172299534.0,
20151211,679172485848,28365988971,29374969639.0,-1008980668.0,2101063966,392705280,39897286,40742725.0,-845439.0,681273549814,677071421882,244270339763.0,1185010647.0,
20151214,686734828731,41328859936,33766517053.0,7562342883.0,2105881193,370443012,36024800,58287068.0,-22262268.0,688840709924,684628947538,278291573450.0,1167036412.0,
20151215,686903667749,37186068080,37017229062.0,168839018.0,2022022178,358313963,24072759,36201808.0,-12129049.0,688925689927,684881645571,275354798356.0,1130129287.0,
20151216,687294173008,34465314026,34074808767.0,390505259.0,2042483132,364969521,32766707,26111149.0,6655558.0,689336656140,685251689876,264656175991.0,965670784.0,
20151217,685514996801,48712938670,50492114877.0,-1779176207.0,2197465782,377411347,46942828,34501002.0,12441826.0,687712462583,683317531019,380362203401.0,1490138747.0,
20151218,685013347232,47396383227,47898032796.0,-501649569.0,2166047057,370577565,27117647,33951429.0,-6833782.0,687179394289,682847300175,364579134578.0,1260118956.0,
20151221,690204973913,57466371747,52274745066.0,5191626681.0,2273711965,387937372,42034047,24674240.0,17359807.0,692478685878,687931261948,397270974915.0,1509923107.0,
20151222,694584343597,52008901722,47629532038.0,4379369684.0,2216629408,379497194,27847268,36287446.0,-8440178.0,696800973005,692367714189,359681838378.0,1650111313.0,
20151223,701576990450,66173764807,59181117954.0,6992646853.0,2305921763,401880906,51599272,29215560.0,22383712.0,703882912213,699271068687,418952479746.0,1523332035.0,
20151224,704055938831,45768190084,43289241703.0,2478948381.0,2162580784,379028086,30225902,53078722.0,-22852820.0,706218519615,701893358047,314588318980.0,1376849319.0,
20151225,702906554042,36861998896,38011383685.0,-1149384789.0,2152587073,375090359,25677739,29615466.0,-3937727.0,705059141115,700753966969,273777495840.0,1421227613.0,
20151228,690842371910,43463435651,55527617783.0,-12064182132.0,2108756268,379235236,32431310,28286433.0,4144877.0,692951128178,688733615642,365846229599.0,3448536293.0,
20151229,689699599137,28878201901,30020974674.0,-1142772773.0,2141562769,384517703,32745600,27463133.0,5282467.0,691841161906,687558036368,248922653472.0,2339591524.0,
20151230,690624418175,34774521611,33849702573.0,924819038.0,2134120717,387461740,26235283,23291246.0,2944037.0,692758538892,688490297458,266267065989.0,1974398258.0,
20151231,680522261155,26481517358,36583674378.0,-10102157020.0,2110497327,389898016,25617261,23180985.0,2436276.0,682632758482,678411763828,253654760609.0,996108319.0,
20160104,674250015171,27746141351,34018387335.0,-6272245984.0,1930428580,378549763,14767084,26115337.0,-11348253.0,676180443751,672319586591,239618316015.0,1310839202.0,
20160105,662424991011,32738126135,44563150295.0,-11825024160.0,1965327469,386320746,31410622,23639639.0,7770983.0,664390318480,660459663542,327060168376.0,1675935523.0,
20160106,659659894611,31039624222,33804720622.0,-2765096400.0,2025469549,397866642,28591279,17045383.0,11545896.0,661685364160,657634425062,284371108033.0,1239057371.0,
20160107,653619923734,8743686393,14783657270.0,-6039970877.0,1865346141,389379514,4980100,13467228.0,-8487128.0,655485269875,651754577593,79590703714.0,391284940.0,
20160108,640940954450,32514181166,45193150450.0,-12678969284.0,1797468141,366022477,20464535,43821572.0,-23357037.0,642738422591,639143486309,322941981786.0,1589501056.0,
20160111,622258836431,28150988168,46833106187.0,-18682118019.0,1722772476,378464622,30254704,17812559.0,12442145.0,623981608907,620536063955,284961047285.0,1665461860.0,
20160112,610486743606,21769602015,33541694840.0,-11772092825.0,1687383077,361694462,20604486,37374646.0,-16770160.0,612174126683,608799360529,223400160573.0,930943545.0,
20160113,600445497232,19525346812,29566593186.0,-10041246374.0,1671474368,367700213,22850084,16844333.0,6005751.0,602116971600,598774022864,207468742147.0,978976021.0,
20160114,594163365933,22803175759,29085307058.0,-6282131299.0,1651483595,352386407,18888607,34202413.0,-15313806.0,595814849528,592511882338,217725368528.0,1047599048.0,
20160115,585478803003,20242663855,28927226785.0,-8684562930.0,1613659931,360131694,28249261,20503974.0,7745287.0,587092462934,583865143072,206262745407.0,931321477.0,
20160118,584010365373,19081125394,20549563024.0,-1468437630.0,1642374141,368936025,23324293,14519962.0,8804331.0,585652739514,582367991232,173259275630.0,700562108.0,
20160119,583401330073,25220485677,25829520977.0,-609035300.0,1761695979,388529453,39923341,20329913.0,19593428.0,585163026052,581639634094,222218764968.0,978667913.0,
20160120,581973101059,25779016479,27207245493.0,-1428229014.0,1710066593,389257526,42551370,41823297.0,728073.0,583683167652,580263034466,234191078552.0,917282019.0,
20160121,577982711229,22361174852,26351564682.0,-3990389830.0,1757858947,399730250,38134401,27661677.0,10472724.0,579740570176,576224852282,202849746828.0,936807611.0,
20160122,574703509699,17864511418,21143712948.0,-3279201530.0,1667792073,377134445,16171099,38766904.0,-22595805.0,576371301772,573035717626,170079087960.0,706973649.0,
20160125,573053955612,16889289523,18538843610.0,-1649554087.0,1696416297,377897322,16201169,15438292.0,762877.0,574750371909,571357539315,164303505922.0,612439862.0,
20160126,558948682056,19547611732,33652885288.0,-14105273556.0,1587722289,386461946,26214474,17649850.0,8564624.0,560536404345,557360959767,212135402876.0,872560958.0,
20160127,546309759767,19749649503,32388571792.0,-12638922289.0,1610207999,371387521,21792114,36866539.0,-15074425.0,547919967766,544699551768,207176251346.0,882865551.0,
20160128,537399576006,14896970875,23807154636.0,-8910183761.0,1540722949,370276921,27725726,28836326.0,-1110600.0,538940298955,535858853057,167125953352.0,610874777.0,
20160129,533033638244,18426533048,22792470810.0,-4365937762.0,1535234350,357231158,22432638,35478401.0,-13045763.0,534568872594,531498403894,179637464546.0,711063134.0,
20160201,528384301655,14080422778,18729759367.0,-4649336589.0,1485180379,353673284,17458549,21016423.0,-3557874.0,529869482034,526899121276,153342432046.0,480711484.0,
20160202,528845887864,17563888365,17102302156.0,461586209.0,1511792608,349593177,17212053,21292160.0,-4080107.0,530357680472,527334095256,158620123656.0,541490569.0,
20160203,526428042632,14409477762,16827322994.0,-2417845232.0,1491080478,344837635,12578548,17334090.0,-4755542.0,527919123110,524936962154,146346362374.0,430064175.0,
20160204,524337017843,18541568615,20632593404.0,-2091024789.0,1482084171,338921731,17319810,23235714.0,-5915904.0,525819102014,522854933672,176342380069.0,610544615.0,
20160205,514093133618,11901318369,22145202594.0,-10243884225.0,1357030571,321846648,15155083,32230166.0,-17075083.0,515450164189,512736103047,145029176541.0,541758186.0,
20160215,515256205943,14930797529,13767725204.0,1163072325.0,1420264176,338742330,33851000,16955318.0,16895682.0,516676470119,513835941767,128868785285.0,494614727.0,
20160216,518215198164,23605306843,20646314622.0,2958992221.0,1545662014,353115874,29933324,15559780.0,14373544.0,519760860178,516669536150,198485236710.0,635812823.0,
20160217,518778341837,24752742440,24189598767.0,563143673.0,1657639909,384911339,39836772,8041307.0,31795465.0,520435981746,517120701928,225755829803.0,618205292.0,
20160218,519382998740,25395778727,24791121824.0,604656903.0,1646122131,383913855,14700841,15698325.0,-997484.0,521029120871,517736876609,230275089944.0,747566901.0,
20160219,517832856204,18210153720,19760296256.0,-1550142536.0,1595130626,371916455,10528154,22525554.0,-11997400.0,519427986830,516237725578,177984461240.0,507316936.0,
20160222,519250340741,27522280606,26104796069.0,1417484537.0,1692811572,386373075,25534802,11078182.0,14456620.0,520943152313,517557529169,238186175993.0,781464097.0,
20160223,519105100581,23392174306,23537414466.0,-145240160.0,1689257065,390237467,15163588,11299196.0,3864392.0,520794357646,517415843516,211891072667.0,520752667.0,
20160224,520489250248,26164786546,24780636879.0,1384149667.0,1730924643,395478038,16853216,11612645.0,5240571.0,522220174891,518758325605,227285978462.0,711569242.0,
20160225,513548523851,28390233205,35330959602.0,-6940726397.0,1632454971,399914491,27139662,22703209.0,4436453.0,515180978822,511916068880,270580194223.0,1188132440.0,
20160226,509938422697,18373537956,21983639110.0,-3610101154.0,1639939436,399871995,25497960,25540456.0,-42496.0,511578362133,508298483261,189625728104.0,625241935.0,
20160229,501041987179,16891230852,25787666370.0,-8896435518.0,1622773378,405231549,23683654,18324100.0,5359554.0,502664760557,499419213801,193929424080.0,737382834.0,
20160301,499909493421,18523989704,19656483462.0,-1132493758.0,1688144824,404307775,23312246,24236020.0,-923774.0,501597638245,498221348597,181811932891.0,508375670.0,
20160302,502350546037,29767561155,27326508539.0,2441052616.0,1779203410,410569729,37776502,31514548.0,6261954.0,504129749447,500571342627,258752073982.0,805048687.0,
20160303,503092878470,31372321447,30629989014.0,742332433.0,1811602760,418744722,27678909,19503916.0,8174993.0,504904481230,501281275710,279712478886.0,619670834.0,
20160304,494927660917,27790003531,35955221084.0,-8165217553.0,1855487471,428495044,38390367,28640045.0,9750322.0,496783148388,493072173446,294526590764.0,556597432.0,
20160307,497412906564,24748130963,22262885316.0,2485245647.0,1835425882,417247123,17338244,28586165.0,-11247921.0,499248332446,495577480682,208403226264.0,421572316.0,
20160308,495750615429,23630997269,25293288404.0,-1662291135.0,1834114044,414150365,19682643,22779401.0,-3096758.0,497584729473,493916501385,220286883970.0,511703678.0,
20160309,492829696125,17033964898,19954884202.0,-2920919304.0,1893220284,430283330,26064592,9931627.0,16132965.0,494722916409,490936475841,176943301222.0,345849726.0,
20160310,492042339533,14785943211,15573299803.0,-787356592.0,1836636431,428684047,11993988,13593271.0,-1599283.0,493878975964,490205703102,141622234915.0,275363674.0,
20160311,489799692896,12450405720,14693052357.0,-2242646637.0,1805079703,420066293,16191312,24809066.0,-8617754.0,491604772599,487994613193,150118307071.0,233977166.0,
20160314,493687362449,23766199588,19878530035.0,3887669553.0,1810427012,411291055,19494774,28270012.0,-8775238.0,495497789461,491876935437,202665415863.0,619862617.0,
20160315,490445133204,16199416635,19441645880.0,-3242229245.0,1861084281,426634136,37963414,22620333.0,15343081.0,492306217485,488584048923,169919507405.0,404180998.0,
20160316,483482073240,14991423218,21954483182.0,-6963059964.0,1891260265,438763762,31708062,19578436.0,12129626.0,485373333505,481590812975,190032035586.0,367419677.0,
20160317,488497078304,26128781409,21113776345.0,5015005064.0,1724225667,374694739,12120751,76189774.0,-64069023.0,490221303971,486772852637,214237309186.0,522776377.0,
20160318,494872388714,39428741515,33053431105.0,6375310410.0,1711273806,368296267,30866936,37265408.0,-6398472.0,496583662520,493161114908,328540344871.0,1090883677.0,
20160321,505682813378,50440582760,39630158096.0,10810424664.0,1710875104,344925865,33931700,57302102.0,-23370402.0,507393688482,503971938274,384141280569.0,938987691.0,
20160322,507364047862,37857788437,36176553953.0,1681234484.0,1604722826,326074971,15475715,34326609.0,-18850894.0,508968770688,505759325036,311239048063.0,630338816.0,
20160323,509741838074,31494180992,29116390780.0,2377790212.0,1636604122,337341767,23831931,12565135.0,11266796.0,511378442196,508105233952,256386935306.0,550434666.0,
20160324,509172156706,31986208234,32555889602.0,-569681368.0,1645545414,352121756,31359522,16579533.0,14779989.0,510817702120,507526611292,274414172704.0,609302070.0,
20160325,508638683094,22318847529,22852321141.0,-533473612.0,1635002895,353769333,40192809,38545232.0,1647577.0,510273685989,507003680199,200868519253.0,432571386.0,
20160328,509242174833,27189283089,26585791350.0,603491739.0,1684440686,372864875,36392082,17296540.0,19095542.0,510926615519,507557734147,232703638238.0,618320390.0,
20160329,508525327296,21930279771,22647127308.0,-716847537.0,1719011642,396181058,47876219,24560036.0,23316183.0,510244338938,506806315654,201903765958.0,557315382.0,
20160330,509691637569,27927803064,26761492791.0,1166310273.0,1774343291,405685748,35280473,25775783.0,9504690.0,511465980860,507917294278,234621846023.0,664198691.0,
20160331,510077307223,31153041676,30767372022.0,385669654.0,1794732449,413712825,25351060,17323983.0,8027077.0,511872039672,508282574774,252260204921.0,504727594.0,
20160401,506119519804,24633167935,28590955354.0,-3957787419.0,1831175662,425548227,28752399,16916997.0,11835402.0,507950695466,504288344142,217665642444.0,516861704.0,
20160405,512243331494,37092235507,30968423817.0,6123811690.0,1822755249,418589155,21010858,27969930.0,-6959072.0,514066086743,510420576245,276761935739.0,610244780.0,
20160406,513684986113,31676123292,30234468673.0,1441654619.0,1833000949,425300564,18494058,11782649.0,6711409.0,515517987062,511851985164,254957326638.0,519365573.0,
20160407,512796499453,28556687517,29445174177.0,-888486660.0,1831830901,430255162,22893346,17938748.0,4954598.0,514628330354,510964668552,244156332376.0,515208817.0,
20160408,509745451220,22781696856,25832745089.0,-3051048233.0,1843290164,439807776,35715099,26162485.0,9552614.0,511588741384,507902161056,207958082807.0,576150334.0,
20160411,512127578457,30698107375,28315980138.0,2382127237.0,1870649303,437973551,14677265,16511490.0,-1834225.0,513998227760,510256929154,253743985667.0,498760674.0,
20160412,510211622132,22416237700,24332194025.0,-1915956325.0,1879843609,442288992,20861007,16545566.0,4315441.0,512091465741,508331778523,207156830090.0,354851162.0,
20160413,514174217320,42312313729,38349718541.0,3962595188.0,1858861764,427622877,28609114,43275229.0,-14666115.0,516033079084,512315355556,331337492218.0,725886845.0,
20160414,515461028742,28430104632,27143293210.0,1286811422.0,1863849047,423652179,21268263,25238961.0,-3970698.0,517324877789,513597179695,235614038447.0,409262787.0,
20160415,513959169343,25338240194,26840099593.0,-1501859399.0,1866486619,424461774,18578694,17769099.0,809595.0,515825655962,512092682724,224819975881.0,338299888.0,
20160418,512273796689,23645109654,25330482308.0,-1685372654.0,1884974375,437920187,34238477,20780064.0,13458413.0,514158771064,510388822314,208763214867.0,382962366.0,
20160419,512299527727,20853636754,20827905716.0,25731038.0,1895798761,445711924,27911578,20119841.0,7791737.0,514195326488,510403728966,181122738387.0,327350039.0,
20160420,506019596565,33417664759,39697595921.0,-6279931162.0,1969683025,459026202,48540371,35226093.0,13314278.0,507989279590,504049913540,310709763372.0,822980258.0,
20160421,504729309486,23671067589,24961354668.0,-1290287079.0,1927995631,455710066,25810818,29126954.0,-3316136.0,506657305117,502801313855,206442170562.0,450146094.0,
20160422,501699887412,15483224766,18512646840.0,-3029422074.0,1837147974,434986489,12498910,33222487.0,-20723577.0,503537035386,499862739438,148764353912.0,266454822.0,
20160425,501105836656,14531444301,15125495057.0,-594050756.0,1888084518,452977787,28658390,10667092.0,17991298.0,502993921174,499217752138,140592217154.0,289427259.0,
20160426,500229477522,14289114810,15165473944.0,-876359134.0,1912955038,452548563,26178572,26607796.0,-429224.0,502142432560,498316522484,134462420586.0,227831503.0,
20160427,499245448785,15286475183,16270503920.0,-984028737.0,1959244221,478036407,38562964,13075120.0,25487844.0,501204693006,497286204564,150270298556.0,260197350.0,
20160428,498679671165,16736075918,17301853538.0,-565777620.0,1971968247,483917118,28580969,22700258.0,5880711.0,500651639412,496707702918,154898835062.0,333909276.0,
20160429,494455780517,12930112151,17154002799.0,-4223890648.0,1889693904,465309165,14545540,33153493.0,-18607953.0,496345474421,492566086613,128445152914.0,191616752.0,
20160503,498068800143,24446886546,20833866920.0,3613019626.0,1916449042,459347061,18254554,24216658.0,-5962104.0,499985249185,496152351101,195646007276.0,411554353.0,
20160504,498378241538,21673655978,21364214583.0,309441395.0,1908585250,459179739,25394240,25561562.0,-167322.0,500286826788,496469656288,189615779209.0,327933174.0,
20160505,498647195271,18795254421,18526300688.0,268953733.0,1866740178,443338759,19508495,35349475.0,-15840980.0,500513935449,496780455093,163329930198.0,244616769.0,
20160506,493019015948,25206015858,30834195181.0,-5628179323.0,1821751220,448117885,35486769,30707643.0,4779126.0,494840767168,491197264728,233739344226.0,491958608.0,
20160509,489787952075,18589026402,21820090275.0,-3231063873.0,1814654742,454084772,33873364,27906477.0,5966887.0,491602606817,487973297333,188297773718.0,522806461.0,
20160510,486770066004,11967954223,14985840294.0,-3017886071.0,1848438009,465327237,31123109,19880644.0,11242465.0,488618504013,484921627995,129011978968.0,282002935.0,
20160511,484223329354,14605560018,17152296668.0,-2546736650.0,1908372766,476347184,26286230,15266283.0,11019947.0,486131702120,482314956588,147018736522.0,371226225.0,
20160512,482195898002,14746480437,16773911789.0,-2027431352.0,1985512603,487960984,33452758,21838958.0,11613800.0,484181410605,480210385399,140774172413.0,334300134.0,
20160513,479835870205,12799334852,15159362649.0,-2360027797.0,1867654477,465843265,15437677,37555396.0,-22117719.0,481703524682,477968215728,123650117507.0,216046866.0,
20160516,479976560380,13682998225,13542308050.0,140690175.0,1865306755,459251370,14189483,20781378.0,-6591895.0,481841867135,478111253625,127263626319.0,214851652.0,
20160517,478828511618,15685066169,16833114931.0,-1148048762.0,1881070331,467485550,23463162,15228982.0,8234180.0,480709581949,476947441287,140709641887.0,186367860.0,
20160518,474780510464,14732885027,18780886181.0,-4048001154.0,1881965580,465470861,35905915,37920604.0,-2014689.0,476662476044,472898544884,149438393116.0,617248797.0,
20160519,474796983383,14160647518,14144174599.0,16472919.0,1744718654,422386820,14410300,57494341.0,-43084041.0,476541702037,473052264729,124841212672.0,433384153.0,
20160520,473967145973,14282633644,15112471054.0,-829837410.0,1729756848,416942266,36595663,42040217.0,-5444554.0,475696902821,472237389125,125139191071.0,402365510.0,
20160523,473790185446,15087136624,15264097151.0,-176960527.0,1753543484,422091594,31403739,26254411.0,5149328.0,475543728930,472036641962,140364899076.0,260349912.0,
20160524,474113760053,14061116207,13737541600.0,323574607.0,1798419073,435897186,34425332,20619740.0,13805592.0,475912179126,472315340980,122934302983.0,151657814.0,
20160525,473248745984,13439435439,14304449508.0,-865014069.0,1819093057,447111489,33450208,22235905.0,11214303.0,475067839041,471429652927,119148166258.0,214817263.0,
20160526,472502816382,14550761697,15296691299.0,-745929602.0,1847415057,449693374,38126177,35544292.0,2581885.0,474350231439,470655401325,127506779844.0,287179301.0,
20160527,470933246425,12946566059,14516136016.0,-1569569957.0,1693078510,408347779,15409047,56754642.0,-41345595.0,472626324935,469240167915,124565857973.0,200117117.0,
20160530,469474286135,12118100614,13577060904.0,-1458960290.0,1788434447,433400007,50249356,25197128.0,25052228.0,471262720582,467685851688,116142598548.0,168375069.0,
20160531,472770517075,29411838246,26115607306.0,3296230940.0,1773404013,399469150,33599650,67530507.0,-33930857.0,474543921088,470997113062,237237365625.0,957618699.0,
20160601,473842939459,26853747104,25781324720.0,1072422384.0,1733878875,389097930,27907000,38278220.0,-10371220.0,475576818334,472109060584,221152428374.0,354846823.0,
20160602,475857307685,22727591932,20713223706.0,2014368226.0,1777461682,400678010,26956835,15376755.0,11580080.0,477634769367,474079846003,185663900647.0,262457261.0,
20160603,473956396588,24400622414,26301533511.0,-1900911097.0,1795161021,400124553,35727267,36280724.0,-553457.0,475751557609,472161235567,213147508047.0,282416989.0,
20160606,474696463629,20389851290,19649784249.0,740067041.0,1807091008,406734589,24680932,18070896.0,6610036.0,476503554637,472889372621,173633857902.0,240426433.0,
20160607,474785801210,18687817684,18598480103.0,89337581.0,1859507222,423323012,34423914,17835491.0,16588423.0,476645308432,472926293988,164528189555.0,164107309.0,
20160608,472230941146,19223668206,21778528270.0,-2554860064.0,2083247021,425791006,49710215,47242221.0,2467994.0,474314188167,470147694125,177492544027.0,302266542.0,
20160613,470718833261,22065754739,23577862624.0,-1512107885.0,1764666802,430977947,58834669,53647728.0,5186941.0,472483500063,468954166459,198311718340.0,461536269.0,
20160614,469814782324,14488643361,15392694298.0,-904050937.0,2140904265,455743898,65977760,41211809.0,24765951.0,471955686589,467673878059,138659509697.0,247654364.0,
20160615,472774017130,25071419447,22112184641.0,2959234806.0,2030176669,444026379,60139809,71857328.0,-11717519.0,474804193799,470743840461,197824167386.0,303519708.0,
20160616,472426696313,22911662035,23258982852.0,-347320817.0,1842035190,417334456,33767428,60459351.0,-26691923.0,474268731503,470584661123,202494076088.0,177691135.0,
20160617,471145006787,22059853838,23341543364.0,-1281689526.0,1767669480,392024143,35213798,60524111.0,-25310313.0,472912676267,469377337307,195582341168.0,267293383.0,
20160620,471899642785,18147176614,17392540616.0,754635998.0,1868935709,400271759,33731307,25483691.0,8247616.0,473768578494,470030707076,164039774538.0,198074968.0,
20160621,471148810549,22369420851,23120253087.0,-750832236.0,1907486817,408942965,49486834,40815628.0,8671206.0,473056297366,469241323732,199053479315.0,311714801.0,
20160622,471757473392,18476704112,17868041269.0,608662843.0,1856200904,402136318,33557104,40363751.0,-6806647.0,473613674296,469901272488,156418455637.0,251867159.0,
20160623,470989946736,19023254037,19790780693.0,-767526656.0,1990896299,431763853,53017447,23389912.0,29627535.0,472980843035,468999050437,164424933670.0,323860033.0,
20160624,469568272060,24668541492,26090216168.0,-1421674676.0,1888549208,430224808,54843576,56382621.0,-1539045.0,471456821268,467679722852,215094096412.0,448556494.0,
20160627,472130992856,23847929426,21285208630.0,2562720796.0,1969519019,439742629,51126452,41608631.0,9517821.0,474100511875,470161473837,194305717978.0,352696425.0,
20160628,473172010473,25173695721,24132678104.0,1041017617.0,2001696516,414451274,40340399,65631754.0,-25291355.0,475173706989,471170313957,213087808999.0,346618692.0,
20160629,475231804471,26788675844,24728881846.0,2059793998.0,2118405363,447815442,64276454,30912286.0,33364168.0,477350209834,473113399108,224339823715.0,321824321.0,
20160630,474937137098,21467742218,21762409591.0,-294667373.0,2101251811,442419821,26303758,31699379.0,-5395621.0,477038388909,472835885287,188040328363.0,208254144.0,
20160701,473366707712,19675919674,21246349060.0,-1570429386.0,2099563495,434497231,35646834,43569424.0,-7922590.0,475466271207,471267144217,174098137026.0,231947281.0,
20160704,477343099023,32130856359,28154465048.0,3976391311.0,2302250937,460635630,62146625,36008226.0,26138399.0,479645349960,475040848086,255140955803.0,424104743.0,
20160705,478894481453,32734362701,31182980271.0,1551382430.0,2446240005,478227617,48180877,30588890.0,17591987.0,481340721458,476448241448,271464190711.0,294408723.0,
20160706,480194633761,29106028080,27805875772.0,1300152308.0,2419211393,491520521,43624495,30331591.0,13292904.0,482613845154,477775422368,247996306546.0,309845140.0,
20160707,480968164323,31988828163,31215297601.0,773530562.0,2487269285,508156060,45517665,28882126.0,16635539.0,483455433608,478480895038,270859580682.0,368303717.0,
20160708,478082382396,23389548398,26275330325.0,-2885781927.0,2349687842,471563001,22199670,58792729.0,-36593059.0,480432070238,475732694554,210511722136.0,212703882.0,
20160711,479342990976,32614662316,31354053736.0,1260608580.0,2469632807,479247541,55737335,48052795.0,7684540.0,481812623783,476873358169,275803954284.0,331592241.0,
20160712,482110757617,36821977122,34054210481.0,2767766641.0,2549096995,476516057,66672703,69404187.0,-2731484.0,484659854612,479561660622,290559824825.0,389255781.0,
20160713,481908335239,36678423531,36880845909.0,-202422378.0,2356322937,423099353,48346342,101763046.0,-53416704.0,484264658176,479552012302,280477755242.0,271298685.0,
20160714,482059531983,27102641122,26951444378.0,151196744.0,2366026078,418557552,43634449,48176250.0,-4541801.0,484425558061,479693505905,213916287836.0,241252725.0,
20160715,481144294514,25326907353,26242144822.0,-915237469.0,2244011673,392322171,30810932,57046313.0,-26235381.0,483388306187,478900282841,203513673431.0,252678146.0,
20160718,483284066990,26067867176,23928094700.0,2139772476.0,2326851515,411505500,45236181,26052852.0,19183329.0,485610918505,480957215475,208424844612.0,196128830.0,
20160719,485650291962,23944297057,21578072085.0,2366224972.0,2313343445,411786317,44047567,43766750.0,280817.0,487963635407,483336948517,189211344471.0,185556926.0,
20160720,486271452106,21205037443,20583877299.0,621160144.0,2339523643,408812651,27612751,30586417.0,-2973666.0,488610975749,483931928463,172041225795.0,203875613.0,
20160721,487493320212,25317838648,24095970542.0,1221868106.0,2446552497,418468884,44999084,35342851.0,9656233.0,489939872709,485046767715,201296935975.0,291118623.0,
20160722,485774399944,24165846980,25884767248.0,-1718920268.0,2273696518,396108001,35511469,57872352.0,-22360883.0,488048096462,483500703426,198305843086.0,213211103.0,
20160725,486965174977,21623531740,20432756707.0,1190775033.0,2265389528,402557515,28996966,22547452.0,6449514.0,489230564505,484699785449,176016781144.0,212932545.0,
20160726,487693941995,23503719129,22774952111.0,728767018.0,2449075034,422853429,50838836,30542922.0,20295914.0,490143017029,485244866961,186384558222.0,263416848.0,
20160727,482124688799,38181156047,43750409243.0,-5569253196.0,2502229053,438321183,76538726,61070972.0,15467754.0,484626917852,479622459746,316741423891.0,733808859.0,
20160728,480421749174,26674128603,28377068228.0,-1702939625.0,2485031794,430378718,51024068,58966533.0,-7942465.0,482906780968,477936717380,217525705187.0,509053135.0,
20160729,478048309022,19644960366,22018400518.0,-2373440152.0,2373197134,412096456,24671710,42953972.0,-18282262.0,480421506156,475675111888,170383856286.0,332272971.0,
20160801,476355670754,18019034247,19711672515.0,-1692638268.0,2352431485,418461422,40136631,33771665.0,6364966.0,478708102239,474003239269,163613449834.0,352017430.0,
20160802,476393053057,14878698033,14841315730.0,37382303.0,2350121715,411015899,28426603,35872126.0,-7445523.0,478743174772,474042931342,129827927757.0,204956040.0,
20160803,476932091555,18468077204,17929038706.0,539038498.0,2460715830,434926411,51204670,27294158.0,23910512.0,479392807385,474471375725,159062402687.0,266668988.0,
20160804,477637950967,18769312405,18063452993.0,705859412.0,2512008832,445576381,44262829,33612859.0,10649970.0,480149959799,475125942135,153828317303.0,168607202.0,
20160805,476692801710,18678111692,19623260949.0,-945149257.0,2474642813,441467482,40057237,44166136.0,-4108899.0,479167444523,474218158897,162683079560.0,149352168.0,
20160808,477819998514,21430172220,20302975416.0,1127196804.0,2615946503,462116396,50381630,29732716.0,20648914.0,480435945017,475204052011,172557020933.0,245169812.0,
20160809,479047204988,22848524757,21621318283.0,1227206474.0,2643024561,460717073,54921971,56321294.0,-1399323.0,481690229549,476404180427,188521424571.0,171967566.0,
20160810,480718943503,22612841898,20941103383.0,1671738515.0,2736885063,482661441,53461075,31516707.0,21944368.0,483455828566,477982058440,184946946435.0,158220191.0,
20160811,480775762109,22024349627,21967531021.0,56818606.0,2772890637,487745002,50664908,45581347.0,5083561.0,483548652746,478002871472,180119853645.0,145486370.0,
20160812,479839424564,22006966793,22943304338.0,-936337545.0,2705740435,465115409,56541175,79170768.0,-22629593.0,482545164999,477133684129,179410528173.0,147286042.0,
20160815,486485232335,45599596654,38953788883.0,6645807771.0,2883440312,456701529,92273965,100687845.0,-8413880.0,489368672647,483601792023,328068406661.0,533509323.0,
20160816,493566088751,41889657998,34808801582.0,7080856416.0,2754629970,425996915,63014807,93719421.0,-30704614.0,496320718721,490811458781,309203774808.0,390076460.0,
20160817,495659051254,32177481153,30084518650.0,2092962503.0,2685725798,411112441,40993272,55877746.0,-14884474.0,498344777052,492973325456,244182085271.0,222081235.0,
20160818,498543748648,35091631592,32206934198.0,2884697394.0,2638732511,403174145,41562691,49500987.0,-7938296.0,501182481159,495905016137,258237146595.0,314881535.0,
20160819,498282428488,28438491033,28699811193.0,-261320160.0,2677317602,420104549,73765265,56834861.0,16930404.0,500959746090,495605110886,212310638939.0,175269597.0,
20160822,499145177131,27494751512,26632002869.0,862748643.0,2738433455,428532762,43399057,34970844.0,8428213.0,501883610586,496406743676,208680431745.0,229492056.0,
20160823,499734417220,23174573771,22585333682.0,589240089.0,2793503662,442672350,57331203,43191615.0,14139588.0,502527920882,496940913558,179814078159.0,178315142.0,
20160824,500400801436,20520998519,19854614303.0,666384216.0,2753149425,437582114,47004479,52094715.0,-5090236.0,503153950861,497647652011,169272363830.0,192381923.0,
20160825,500791792381,23464991931,23074000986.0,390990945.0,2748060930,440284911,53762538,51059741.0,2702797.0,503539853311,498043731451,201108564106.0,251877283.0,
20160826,499937745356,20244740587,21098787612.0,-854047025.0,2648511173,413193125,34680854,61772640.0,-27091786.0,502586256529,497289234183,177145363946.0,183837470.0,
20160829,501477435834,19262597443,17722906965.0,1539690478.0,2723176228,433383078,52040537,31850584.0,20189953.0,504200612062,498754259606,167263528165.0,158081090.0,
20160830,501004637549,18127747375,18600545660.0,-472798285.0,2942132684,459464394,68741513,42660197.0,26081316.0,503946770233,498062504865,164321055836.0,156907123.0,
20160831,501716007963,20539638820,19828268406.0,711370414.0,2972281463,445541370,54635530,68558554.0,-13923024.0,504688289426,498743726500,169955592624.0,195476588.0,
20160901,501535695782,20956719333,21137031514.0,-180312181.0,3021949312,464663438,61126202,42004134.0,19122068.0,504557645094,498513746470,178154848869.0,164388912.0,
20160902,499592197550,19720914539,21664412771.0,-1943498232.0,3055378796,477936580,75347741,62074599.0,13273142.0,502647576346,496536818754,171930209794.0,138455065.0,
20160905,500516748119,19738718257,18814167688.0,924550569.0,2926669963,470316954,58457638,66077264.0,-7619626.0,503443418082,497590078156,161490638161.0,145550960.0,
20160906,503013816371,24868965139,22371896887.0,2497068252.0,2942855884,466174782,55852469,59994641.0,-4142172.0,505956672255,500070960487,193833120696.0,217300539.0,
20160907,503273563343,25787343636,25527596664.0,259746972.0,3021243613,486415126,58620249,38379905.0,20240344.0,506294806956,500252319730,209692861532.0,264954772.0,
20160908,503708906192,19861671600,19426328751.0,435342849.0,2941733401,464077236,31236471,53574361.0,-22337890.0,506650639593,500767172791,167137541557.0,175385695.0,
20160909,501701136676,21402589584,23410359100.0,-2007769516.0,2887751901,456713699,34540563,41904100.0,-7363537.0,504588888577,498813384775,182550231795.0,242048437.0,
20160912,499740145178,25293646673,27254638171.0,-1960991498.0,2893896356,465709861,66451677,57455515.0,8996162.0,502634041534,496846248822,221995074569.0,430662282.0,
20160913,499635099269,18045851868,18150897777.0,-105045909.0,2715487728,426244384,30621776,70087253.0,-39465477.0,502350586997,496919611541,153511277550.0,157233265.0,
20160914,496229314357,15678069181,19083854093.0,-3405784912.0,2560130168,399261828,33751163,60733719.0,-26982556.0,498789444525,493669184189,149066391254.0,196385653.0,
20160919,497965398653,15970987319,14234903023.0,1736084296.0,2886141226,458113075,97715212,38863965.0,58851247.0,500851539879,495079257427,134395141382.0,161928145.0,
20160920,498636196708,15176233151,14505435096.0,670798055.0,2789447018,448011985,46584823,56685913.0,-10101090.0,501425643726,495846749690,140356446557.0,133058118.0,
20160921,498866810752,14949437717,14718823673.0,230614044.0,2786995059,446683649,45304902,46633238.0,-1328336.0,501653805811,496079815693,134782617823.0,165917533.0,
20160922,497769188223,18424362327,19521984856.0,-1097622529.0,2842252320,449913652,40987349,37757346.0,3230003.0,500611440543,494926935903,159383992965.0,249377608.0,
20160923,495548458994,15777430126,17998159355.0,-2220729229.0,2757532261,443885874,36732719,42760497.0,-6027778.0,498305991255,492790926733,148360632899.0,327220489.0,
20160926,495311007534,18398310421,18635761881.0,-237451460.0,2921256301,476130925,79824556,47579505.0,32245051.0,498232263835,492389751233,163320962610.0,323583608.0,
20160927,494949863817,14803735855,15164879572.0,-361143717.0,2904498020,462171998,52782678,66741605.0,-13958927.0,497854361837,492045365797,134484508487.0,221989402.0,
20160928,493935142585,12346963447,13361684679.0,-1014721232.0,2761111210,449641915,35129214,47659297.0,-12530083.0,496696253795,491174031375,117110253686.0,235009161.0,
20160929,492459294682,13966699339,15442547242.0,-1475847903.0,2559643250,397543343,30521234,82619806.0,-52098572.0,495018937932,489899651432,123270784890.0,278301461.0,
20160930,485368046034,10947748818,18038997466.0,-7091248648.0,2302076042,363099308,8089909,42533944.0,-34444035.0,487670122076,483065969992,113294038436.0,241185963.0,
20161010,490131918314,23559668411,18795796131.0,4763872280.0,2485754138,375738521,51608471,38969258.0,12639213.0,492617672452,487646164176,175795890958.0,361658191.0,
20161011,493155823819,23454512182,20430606677.0,3023905505.0,2815512031,418551097,77300340,34487764.0,42812576.0,495971335850,490340311788,184307889724.0,331066657.0,
20161012,495554017689,18404348514,16006154644.0,2398193870.0,2690801688,406734625,36990083,48806555.0,-11816472.0,498244819377,492863216001,160480573039.0,230646142.0,
20161013,497309822724,20303030805,18547225770.0,1755805035.0,3013468547,438553008,66699273,34880890.0,31818383.0,500323291271,494296354177,167729307909.0,264509727.0,
20161014,496412883860,19548242666,20445181530.0,-896938864.0,2891899790,422481098,44694709,60766619.0,-16071910.0,499304783650,493520984070,163931450270.0,223065663.0,
20161017,498028728910,22216720236,20600875186.0,1615845050.0,2866511869,420388098,62002962,64095962.0,-2093000.0,500895240779,495162217041,180320971228.0,1149750047.0,
20161018,501292033743,25202934394,21939629561.0,3263304833.0,2805307720,392963150,56407223,83832171.0,-27424948.0,504097341463,498486726023,195808578185.0,668696493.0,
20161019,502224582657,24632359171,23699810257.0,932548914.0,2818854308,402945727,54739907,44757330.0,9982577.0,505043436965,499405728349,197525072376.0,462782022.0,
20161020,502719680826,20264716528,19769618359.0,495098169.0,2786501246,396722645,35699000,41922082.0,-6223082.0,505506182072,499933179580,178268835376.0,229626465.0,
20161021,502362504192,24048546481,24405723115.0,-357176634.0,2929633779,419385750,67679796,45016691.0,22663105.0,505292137971,499432870413,202184556126.0,351913894.0,
20161024,506651209666,31973297399,27684591925.0,4288705474.0,3062310997,433450220,71104158,57039688.0,14064470.0,509713520663,503588898669,251001731605.0,438123662.0,
20161025,509481313469,28013985325,25183881522.0,2830103803.0,2938692369,399692664,31563950,65321506.0,-33757556.0,512420005838,506542621100,221417531991.0,425929995.0,
20161026,511241718608,26837389154,25076984015.0,1760405139.0,3047214321,446092326,76024903,29625241.0,46399662.0,514288932929,508194504287,216398712249.0,282658968.0,
20161027,512147647095,22057706294,21151777807.0,905928487.0,2867404567,394421882,29135306,80805750.0,-51670444.0,515015051662,509280242528,185810144897.0,269020963.0,
20161028,508646408411,23432607213,26933845897.0,-3501238684.0,2942339368,414787502,65997917,45632297.0,20365620.0,511588747779,505704069043,213206924935.0,232076209.0,
20161031,510247896561,19877461369,18275973219.0,1601488150.0,2889058916,394882433,44174035,64079104.0,-19905069.0,513136955477,507358837645,181810809343.0,234130488.0,
20161101,512090091838,22527066066,20684870789.0,1842195277.0,2980140097,405192780,47955298,37644951.0,10310347.0,515070231935,509109951741,197605384370.0,214031332.0,
20161102,512202186235,25005871992,24893777595.0,112094397.0,2978091658,405074419,45269483,45387844.0,-118361.0,515180277893,509224094577,223456018361.0,268017851.0,
20161103,516372674587,35185628006,31015139654.0,4170488352.0,3185394756,432318559,75471916,48227776.0,27244140.0,519558069343,513187279831,266171184435.0,318035206.0,
20161104,515916361686,27702389256,28158702157.0,-456312901.0,3027101051,412984066,48299358,67633851.0,-19334493.0,518943462737,512889260635,240520892802.0,226841628.0,
20161107,517199830196,25675769223,24392300713.0,1283468510.0,3167668799,442842002,71740701,41882765.0,29857936.0,520367498995,514032161397,211318599893.0,217212067.0,
20161108,517880324403,27167238686,26486744479.0,680494207.0,3333262968,462988347,84189547,64043202.0,20146345.0,521213587371,514547061435,222849759885.0,253578911.0,
20161109,520589849944,35512155182,32802629641.0,2709525541.0,3192679339,462410746,82817210,83394811.0,-577601.0,523782529283,517397170605,277433787799.0,313384548.0,
20161110,524100406163,35916279752,32405723533.0,3510556219.0,3430919078,486231069,93839585,70019262.0,23820323.0,527531325241,520669487085,287254244547.0,406392853.0,
20161111,524606038523,43717351669,43211719309.0,505632360.0,3451229128,482698727,84919692,88452034.0,-3532342.0,528057267651,521154809395,344073363950.0,522152292.0,
20161114,530434954651,47161377775,41332461647.0,5828916128.0,3455894457,496669558,99913739,85942908.0,13970831.0,533890849108,526979060194,347645445075.0,452836087.0,
20161115,532962827325,35512135262,32984262588.0,2527872674.0,3515075241,476691015,68217977,88196520.0,-19978543.0,536477902566,529447752084,268099162163.0,376603490.0,
20161116,535701347651,31599321935,28860801609.0,2738520326.0,3369798586,482953798,72436987,66174204.0,6262783.0,539071146237,532331549065,245522710053.0,399272243.0,
20161117,536057751317,29092021043,28735617377.0,356403666.0,3591333097,519016876,91203935,55140857.0,36063078.0,539649084414,532466418220,227973868994.0,321026195.0,
20161118,535057333809,28680837457,29681254965.0,-1000417508.0,3342644447,505681128,82417417,95753165.0,-13335748.0,538399978256,531714689362,237560487604.0,320260815.0,
20161121,538823020390,32816415500,29050728919.0,3765686581.0,3515686889,510095248,91673033,87258913.0,4414120.0,542338707279,535307333501,264215244681.0,294162421.0,
20161122,542008130531,37589023793,34403913652.0,3185110141.0,3586448687,542024944,106051188,74121492.0,31929696.0,545594579218,538421681844,294040175167.0,335643129.0,
20161123,541686542434,35396629202,35718217299.0,-321588097.0,3586996836,526193407,74331524,90163061.0,-15831537.0,545273539270,538099545598,279135058973.0,255146297.0,
20161124,541913908842,33906643087,33679276679.0,227366408.0,3824549910,567936112,106844753,65102048.0,41742705.0,545738458752,538089358932,272769133042.0,225643506.0,
20161125,541073208543,34030570478,34871270777.0,-840700299.0,3584196203,501453341,63936966,130419737.0,-66482771.0,544657404746,537489012340,260039916007.0,288373527.0,
20161128,546721796406,41134076209,35485488346.0,5648587863.0,3889652394,572810333,129391632,58034640.0,71356992.0,550611448800,542832144012,304088813178.0,232973742.0,
20161129,550196731263,49413534718,45938599861.0,3474934857.0,3827897378,544702721,94585947,122693559.0,-28107612.0,554024628641,546368833885,349722176558.0,356370425.0,
20161130,553319387731,38009703417,34887046949.0,3122656468.0,3623238146,506692809,50799789,88809701.0,-38009912.0,556942625877,549696149585,263360792797.0,269751989.0,
20161201,555785149855,36512524580,34046762456.0,2465762124.0,3841995830,552004472,100266615,54954952.0,45311663.0,559627145685,551943154025,262285770558.0,150876847.0,
20161202,552942591967,37792654678,40635212566.0,-2842557888.0,3646377298,495343851,68000163,124660784.0,-56660621.0,556588969265,549296214669,282760890869.0,205567505.0,
20161205,552584304283,32964380204,33322667888.0,-358287684.0,3459620852,503114693,100734285,92963443.0,7770842.0,556043925135,549124683431,239788515429.0,210203916.0,
20161206,552796495709,22502287281,22290095855.0,212191426.0,3420881587,486530914,83049594,99633373.0,-16583779.0,556217377296,549375614122,178959015305.0,208498358.0,
20161207,553519950153,24070429642,23346975198.0,723454444.0,3533985798,489271972,83557693,80816635.0,2741058.0,557053935951,549985964355,190821390577.0,177861399.0,
20161208,554108985855,23898531152,23309495450.0,589035702.0,3692335096,519305685,95894711,65860998.0,30033713.0,557801320951,550416650759,198746021026.0,188029925.0,
20161209,552842108711,26820353251,28087230395.0,-1266877144.0,3669446342,538778789,93808717,74335613.0,19473104.0,556511555053,549172662369,228060682702.0,187724216.0,
20161212,545636500112,31162678070,38368286669.0,-7205608599.0,3579624571,517859220,83839951,104759520.0,-20919569.0,549216124683,542056875541,294504675350.0,407176131.0,
20161213,545857484973,21736669175,21515684314.0,220984861.0,3258606848,457275910,67786023,128369333.0,-60583310.0,549116091821,542598878125,203429634938.0,261139471.0,
20161214,547536309834,26484861643,24806036782.0,1678824861.0,3253930817,465077218,80933727,73132419.0,7801308.0,550790240651,544282379017,219307058133.0,314903118.0,
20161215,549415404110,24392317065,22513222789.0,1879094276.0,3081793935,443548145,81333331,102862404.0,-21529073.0,552497198045,546333610175,213371074527.0,285526192.0,
20161216,547544828889,18239764248,20110339469.0,-1870575221.0,2939297065,412000314,56281638,87829469.0,-31547831.0,550484125954,544605531824,191019330410.0,314942826.0,
20161219,547210251108,18200653755,18535231536.0,-334577781.0,2929726450,403906740,65519502,73613076.0,-8093574.0,550139977558,544280524658,176826215041.0,317387981.0,
20161220,548400035764,18737420154,17547635498.0,1189784656.0,2862197707,392934181,59466063,70438622.0,-10972559.0,551262233471,545537838057,173348234913.0,202289089.0,
20161221,549096724136,22122050674,21425362302.0,696688372.0,3096966389,402364088,92112448,82682541.0,9429907.0,552193690525,545999757747,207908897422.0,188379325.0,
20161222,548638718046,19296334236,19754340326.0,-458006090.0,2961458772,420642645,92968466,74689909.0,18278557.0,551600176818,545677259274,186550989922.0,271116822.0,
20161223,544894505934,19043031252,22787243364.0,-3744212112.0,2956020933,400283208,59553988,79913425.0,-20359437.0,547850526867,541938485001,189920912674.0,233724991.0,
20161226,545743760642,19619483085,18770228377.0,849254708.0,2897953730,418642842,92797165,74437531.0,18359634.0,548641714372,542845806912,171322296953.0,169578464.0,
20161227,546989121102,17809785774,16564425314.0,1245360460.0,2771776523,375557145,35705009,78790706.0,-43085697.0,549760897625,544217344579,166902397526.0,156840239.0,
20161228,547380152489,16009398832,15618367445.0,391031387.0,2630404190,382417435,55373111,48512821.0,6860290.0,550010556679,544749748299,156569909572.0,154076825.0,
20161229,546781977610,15751094213,16349269092.0,-598174879.0,2670847647,374559216,57849241,65707460.0,-7858219.0,549452825257,544111129963,151492330171.0,138666312.0,
20161230,541744074134,14344231540,19382135016.0,-5037903476.0,2907720287,445295507,120410464,49674173.0,70736291.0,544651794421,538836353847,153002278311.0,155589907.0,
20170103,541086585301,16133800643,16791289476.0,-657488833.0,2751779090,396621694,60364739,109038552.0,-48673813.0,543838364391,538334806211,160535895960.0,208538458.0,
20170104,540266946445,19600153246,20419792102.0,-819638856.0,2827996656,411284970,77535673,62872397.0,14663276.0,543094943101,537438949789,197005356668.0,267326750.0,
20170105,539549321455,19822922714,20540547704.0,-717624990.0,2988885418,432558412,73640617,52367175.0,21273442.0,542538206873,536560436037,200672259526.0,226935871.0,
20170106,537500878600,19869471573,21917914428.0,-2048442855.0,2858333974,418582234,58039504,72015682.0,-13976178.0,540359212574,534642544626,207985436843.0,224626624.0,
20170109,537718895628,20095812115,19877795087.0,218017028.0,3151701673,451035138,91852042,59399138.0,32452904.0,540870597301,534567193955,193003044295.0,176843921.0,
20170110,536648846867,20212691796,21282740557.0,-1070048761.0,3159415794,466512102,93465888,77988924.0,15476964.0,539808262661,533489431073,196629165681.0,188346298.0,
20170111,535042445743,18902724719,20509125843.0,-1606401124.0,3257103313,464150097,89826296,92188301.0,-2362005.0,538299549056,531785342430,189999481300.0,182389894.0,
20170112,533756166491,15745649736,17031928988.0,-1286279252.0,3147374871,449814088,63277969,77613978.0,-14336009.0,536903541362,530608791620,162105377743.0,156341839.0,
20170113,528892909817,14808474716,19671731390.0,-4863256674.0,3147160699,434442382,52882035,68253741.0,-15371706.0,532040070516,525745749118,174646047482.0,184149388.0,
20170116,516166619858,18744123693,31470413652.0,-12726289959.0,3366270199,468408987,89447836,55481231.0,33966605.0,519532890057,512800349659,262941451164.0,462437503.0,
20170117,515589498006,14304069471,14881191323.0,-577121852.0,3276346000,459513260,62246078,71141805.0,-8895727.0,518865844006,512313152006,157092449286.0,226803431.0,
20170118,514074153163,13462077516,14977422359.0,-1515344843.0,3357240293,479292071,97458732,77679921.0,19778811.0,517431393456,510716912870,146152370647.0,142677392.0,
20170119,513286356018,12150234652,12938031797.0,-787797145.0,3181768033,446701660,73466992,106057403.0,-32590411.0,516468124051,510104587985,139639997847.0,135450493.0,
20170120,511151354556,12168333608,14303335070.0,-2135001462.0,2875530522,388998751,39181012,96883921.0,-57702909.0,514026885078,508275824034,142330935596.0,158411688.0,
20170123,510210195581,14558396547,15499555522.0,-941158975.0,2895853009,396351948,57943826,50590629.0,7353197.0,513106048590,507314342572,149074057786.0,150947209.0,
20170124,507524064123,12326827603,15012959061.0,-2686131458.0,2878112906,390931193,49957366,55378121.0,-5420755.0,510402177029,504645951217,134961739317.0,151438780.0,
20170125,505982240630,12266684836,13808508329.0,-1541823493.0,2796884705,377504073,29154433,42581553.0,-13427120.0,508779125335,503185355925,127071463252.0,78209937.0,
20170126,498374008721,10368831308,17977063217.0,-7608231909.0,2547782617,334573344,6634730,49565459.0,-42930729.0,500921791338,495826226104,125014787714.0,175033838.0,
20170203,501587053948,13012665745,9799620518.0,3213045227.0,2591392792,352372799,36738999,18939544.0,17799455.0,504178446740,498995661156,107887205317.0,180165795.0,
20170206,505094124703,15607866098,12100795343.0,3507070755.0,2729574011,375470591,52236915,29139123.0,23097792.0,507823698714,502364550692,151113435968.0,141626457.0,
20170207,505290510411,14733134047,14536748339.0,196385708.0,2855342420,412826548,82443370,45087413.0,37355957.0,508145852831,502435167991,152698404881.0,134959171.0,
20170208,507120995154,17527851456,15697366713.0,1830484743.0,2990431779,409666257,76546068,79706359.0,-3160291.0,510111426933,504130563375,172037719779.0,156134892.0,
20170209,510301910232,22663085338,19482170260.0,3180915078.0,2999102374,400907979,55866642,64624920.0,-8758278.0,513301012606,507302807858,210534549801.0,192970012.0,
20170210,509501164991,25684293331,26485038572.0,-800745241.0,3058976919,410361347,62794133,53340765.0,9453368.0,512560141910,506442188072,246587791730.0,281824764.0,
20170213,512891126892,25494319077,22104357176.0,3389961901.0,3318538647,474961612,112808145,48207880.0,64600265.0,516209665539,509572588245,237680590405.0,261019648.0,
20170214,514493589292,21279556607,19677094207.0,1602462400.0,3268476365,465276441,73376299,83061470.0,-9685171.0,517762065657,511225112927,205208396670.0,227718451.0,
20170215,516029816019,26582091963,25045865236.0,1536226727.0,3908627729,577216411,172808330,60868360.0,111939970.0,519938443748,512121188290,259231242764.0,367969039.0,
20170216,518855552701,24226319951,21400583269.0,2825736682.0,3522402466,497641495,90600375,170175291.0,-79574916.0,522377955167,515333150235,227693425251.0,305612150.0,
20170217,517982129346,23551677476,24425100831.0,-873423355.0,3773835126,531053784,140709278,107296989.0,33412289.0,521755964472,514208294220,249515847842.0,255878513.0,
20170220,521797169713,25567213705,21752173338.0,3815040367.0,3866762853,535693977,141555583,136915390.0,4640193.0,525663932566,517930406860,250826510989.0,417764380.0,
20170221,522276159654,24195255065,23716265124.0,478989941.0,4057502951,552630286,136474786,119538477.0,16936309.0,526333662605,518218656703,233926550530.0,419201633.0,
20170222,523705409158,23833320262,22404070758.0,1429249504.0,3611107166,466719650,70124623,156035259.0,-85910636.0,527316516324,520094301992,235584550567.0,352270373.0,
20170223,525817689808,24686882954,22574602304.0,2112280650.0,3538553924,463593460,77599461,80725651.0,-3126190.0,529356243732,522279135884,238753606190.0,331921633.0,
20170224,525654220836,20653683582,20817152554.0,-163468972.0,3375705081,442003649,73231895,94821706.0,-21589811.0,529029925917,522278515755,214006156971.0,358055433.0,
20170227,527293793769,21363145133,19723572200.0,1639572933.0,3394063149,435707217,62601584,68898016.0,-6296432.0,530687856918,523899730620,211643022020.0,291063347.0,
20170228,528856868250,17727446342,16164371861.0,1563074481.0,3375593438,436680068,77633637,76660786.0,972851.0,532232461688,525481274812,186664304743.0,234253821.0,
20170301,529809697429,23292334150,22339504971.0,952829179.0,3618715780,491345625,137602688,82937131.0,54665557.0,533428413209,526190981649,226216255260.0,357464391.0,
20170302,530170254941,21211857140,20851299628.0,360557512.0,3444258201,457719608,86960634,120586651.0,-33626017.0,533614513142,526725996740,224199045581.0,224490900.0,
20170303,527920521386,17751141610,20000875165.0,-2249733555.0,3429794174,445341587,80359868,92737889.0,-12378021.0,531350315560,524490727212,193374948611.0,228309202.0,
20170306,529865824898,19035648329,17090344817.0,1945303512.0,3651107823,493776623,125493938,77058902.0,48435036.0,533516932721,526214717075,194346246642.0,212525323.0,
20170307,530273177529,19485234256,19077881625.0,407352631.0,3616213870,491243853,99350175,101882945.0,-2532770.0,533889391399,526656963659,210739774507.0,181092681.0,
20170308,530463329116,19129029367,18938877780.0,190151587.0,3991511979,555681475,132238974,67801352.0,64437622.0,534454841095,526471817137,198669015019.0,184274804.0,
20170309,529818259278,18223640546,18868710384.0,-645069838.0,3801715306,510483270,79065654,124263859.0,-45198205.0,533619974584,526016543972,199520073230.0,181550796.0,
20170310,527549728744,14551982050,16820512584.0,-2268530534.0,3757623238,513297363,72574808,69760715.0,2814093.0,531307351982,523792105506,174910705118.0,146752682.0,
20170313,528649018916,19181433874,18082143702.0,1099290172.0,3894708619,526077356,99878074,87098081.0,12779993.0,532543727535,524754310297,207644198613.0,178565182.0,
20170314,528737903013,16667190566,16578306469.0,88884097.0,3938830543,511577456,75715211,90215111.0,-14499900.0,532676733556,524799072470,192403742362.0,226754422.0,
20170315,529674658034,17217866925,16281111904.0,936755021.0,3933798944,536562774,97679618,72694300.0,24985318.0,533608456978,525740859090,186437761406.0,207188590.0,
20170316,532829101634,23318841374,20164397774.0,3154443600.0,3895170160,502892302,71113627,104784099.0,-33670472.0,536724271794,528933931474,246227525768.0,283627169.0,
20170317,532459710928,22348530287,22717920993.0,-369390706.0,3891214217,517640400,108052757,93304659.0,14748098.0,536350925145,528568496711,262414431802.0,316439319.0,
20170320,534227970661,19660736723,17892476990.0,1768259733.0,3805301811,494457663,77614402,100797139.0,-23182737.0,538033272472,530422668850,215370687023.0,172779828.0,
20170321,535559713983,20023598664,18691855342.0,1331743322.0,4052216015,541482778,116874518,69849403.0,47025115.0,539611929998,531507497968,220210069263.0,180591934.0,
20170322,536932700690,23446729286,22073742579.0,1372986707.0,4043393233,542650229,104908096,103740645.0,1167451.0,540976093923,532889307457,246025230635.0,276098118.0,
20170323,537516709084,23094288813,22510280419.0,584008394.0,4079025716,543490693,107641968,106801504.0,840464.0,541595734800,533437683368,258785306026.0,830358306.0,
20170324,537615245684,26140732123,26042195523.0,98536600.0,4005834858,519893856,102982576,126579413.0,-23596837.0,541621080542,533609410826,267981703701.0,337469459.0,
20170327,540023946311,24213194147,21804493520.0,2408700627.0,3946526092,514332643,87670770,93231983.0,-5561213.0,543970472403,536077420219,249875985422.0,314615324.0,
20170328,540813227571,18673565474,17884284214.0,789281260.0,3829041194,504487923,71959088,81803808.0,-9844720.0,544642268765,536984186377,204572943781.0,168861306.0,
20170329,541086656099,23524572352,23251143824.0,273428528.0,4198738904,557733353,132555423,79309993.0,53245430.0,545285395003,536887917195,246648760974.0,317091237.0,
20170330,539868684692,25347341220,26565312627.0,-1217971407.0,3780142914,499384107,85869645,144218891.0,-58349246.0,543648827606,536088541778,266059435663.0,380377725.0,
20170331,535699641718,18508132159,22677175133.0,-4169042974.0,3634290548,473099490,70702324,96986941.0,-26284617.0,539333932266,532065351170,214155035415.0,228986930.0,
20170405,538711252185,29640369957,26628759490.0,3011610467.0,3766704447,476602630,76420586,72917446.0,3503140.0,542477956632,534944547738,273194022434.0,436532927.0,
20170406,539083167166,30020955275,29649040294.0,371914981.0,3987295361,530171797,117641633,64072466.0,53569167.0,543070462527,535095871805,263080616235.0,249332037.0,
20170407,537567404709,28121270901,29637033358.0,-1515762457.0,3858152336,502944528,95871406,123098675.0,-27227269.0,541425557045,533709252373,267477657164.0,209776675.0,
20170410,539288405156,29553694476,27832694029.0,1721000447.0,4038400765,535824965,121327931,88447494.0,32880437.0,543326805921,535250004391,281163481445.0,228880191.0,
20170411,543405620610,39238294257,35121078803.0,4117215454.0,4076179298,517653541,104226667,122398091.0,-18171424.0,547481799908,539329441312,328457090721.0,291595208.0,
20170412,544699793451,36239017710,34944844869.0,1294172841.0,4105700165,536859860,119745075,100538756.0,19206319.0,548805493616,540594093286,313051413599.0,212109168.0,
20170413,547157833162,26347090124,23889050413.0,2458039711.0,4203291371,562001793,134339351,109197418.0,25141933.0,551361124533,542954541791,224673647018.0,152802885.0,
20170414,544867962113,24989821214,27279692263.0,-2289871049.0,3869038787,509818438,96423293,148606648.0,-52183355.0,548737000900,540998923326,224641869276.0,235343315.0,
20170417,546164795221,25427479080,24130645972.0,1296833108.0,3842612083,505299918,93761340,98279860.0,-4518520.0,550007407304,542322183138,227234417204.0,180807819.0,
20170418,546435281623,23858788054,23588301652.0,270486402.0,3861892996,504274062,91867270,92893126.0,-1025856.0,550297174619,542573388627,212323301317.0,143153772.0,
20170419,545115793014,23401019016,24720507625.0,-1319488609.0,3765069054,495343117,98903372,107834317.0,-8930945.0,548880862068,541350723960,226104893636.0,314065634.0,
20170420,543909595954,23378624663,24584821723.0,-1206197060.0,3698528698,475675681,78574764,98242200.0,-19667436.0,547608124652,540211067256,220276478074.0,175712870.0,
20170421,538608445810,17034426828,22335576972.0,-5301150144.0,3565027877,454613394,54522133,75584420.0,-21062287.0,542173473687,535043417933,185095494203.0,113235133.0,
20170424,534439269559,18627416369,22796592620.0,-4169176251.0,3800943303,496832358,96017428,53798464.0,42218964.0,538240212862,530638326256,198442585177.0,192946934.0,
20170425,533464968435,18205648475,19179949599.0,-974301124.0,3906328991,490434136,85108206,91506428.0,-6398222.0,537371297426,529558639444,175457419618.0,164986412.0,
20170426,533367272469,21271519456,21369215422.0,-97695966.0,3880363204,500197656,92953893,83190373.0,9763520.0,537247635673,529486909265,197499415269.0,171081801.0,
20170427,533515685576,24547035898,24398622791.0,148413107.0,3932938087,478363323,78172838,100007171.0,-21834333.0,537448623663,529582747489,237704033889.0,222412624.0,
20170428,530329667127,17646789342,20832807791.0,-3186018449.0,3671006916,442441225,40160912,76083010.0,-35922098.0,534000674043,526658660211,183480069622.0,181837348.0,
20170502,531259620369,19054167988,18124214746.0,929953242.0,3772831406,467163116,58206813,33484922.0,24721891.0,535032451775,527486788963,176456974220.0,157154211.0,
20170503,531245801538,18307201838,18321020669.0,-13818831.0,3952918760,488721074,76819853,55261895.0,21557958.0,535198720298,527292882778,190979489530.0,142102827.0,
20170504,532685207766,21326203514,19886797286.0,1439406228.0,3978450329,494841508,71709753,65589319.0,6120434.0,536663658095,528706757437,200318771595.0,135967209.0,
20170505,528720181291,17642881394,21607907869.0,-3965026475.0,3975583520,492128168,70570041,73283381.0,-2713340.0,532695764811,524744597771,200396718602.0,291683452.0,
20170508,525347761304,17661258004,21033677991.0,-3372419987.0,3993596773,510950712,77930079,59107535.0,18822544.0,529341358077,521354164531,198698361428.0,203652293.0,
20170509,525065572900,14802506208,15084694612.0,-282188404.0,3854767665,477961076,46586689,79576325.0,-32989636.0,528920340565,521210805235,152966747260.0,170329157.0,
20170510,522366049656,16913800523,19613323767.0,-2699523244.0,4013054062,527164831,97212064,48008309.0,49203755.0,526379103718,518352995594,184030936052.0,143524349.0,
20170511,517233414474,17818195260,22950830442.0,-5132635182.0,4006363416,511674349,76433190,91923672.0,-15490482.0,521239777890,513227051058,199354556122.0,202010736.0,
20170512,514216422190,16141980020,19158972304.0,-3016992284.0,4033272324,532636804,92045367,71082912.0,20962455.0,518249694514,510183149866,176231441459.0,134554982.0,
20170515,512648970078,14169922128,15737374240.0,-1567452112.0,4091657734,527045623,47642418,53233599.0,-5591181.0,516740627812,508557312344,159021204682.0,93968913.0,
20170516,513823056434,20398247737,19224161381.0,1174086356.0,4069617288,524493585,70225364,72777402.0,-2552038.0,517892673722,509753439146,193568671069.0,191705818.0,
20170517,514477174094,19530215983,18876098323.0,654117660.0,3975605787,507525428,57080525,74048682.0,-16968157.0,518452779881,510501568307,195756591473.0,158738671.0,
20170518,514821195735,15739964577,15395942936.0,344021641.0,3762927712,493590589,57542796,71477635.0,-13934839.0,518584123447,511058268023,168715238485.0,95757560.0,
20170519,513118335966,13744223490,15447083259.0,-1702859769.0,3717253796,476936675,41331348,57985262.0,-16653914.0,516835589762,509401082170,150890903993.0,70592921.0,
20170522,512246774771,15648617871,16520179066.0,-871561195.0,3943705129,512586026,79594823,43945472.0,35649351.0,516190479900,508303069642,170969265298.0,115174291.0,
20170523,509405303323,18273912915,21115384363.0,-2841471448.0,4084368599,523813690,81487675,70260011.0,11227664.0,513489671922,505320934724,196076474633.0,185244523.0,
20170524,509246104228,15052025458,15211224553.0,-159199095.0,4084972437,540974469,106494589,89333810.0,17160779.0,513331076665,505161131791,153078994346.0,151664869.0,
20170525,509448789631,21641618054,21438932651.0,202685403.0,4144147054,526798065,114121065,128297469.0,-14176404.0,513592936685,505304642577,202358434391.0,164157083.0,
20170526,505837079759,15608091455,19219801327.0,-3611709872.0,3747120231,479404849,54388359,101781575.0,-47393216.0,509584199990,502089959528,171898475939.0,88171943.0,
20170531,506079239855,17477355035,17235194939.0,242160096.0,3819410833,470297887,64687195,73794157.0,-9106962.0,509898650688,502259829022,178036633529.0,243543594.0,
20170601,502881436275,15656546673,18854350253.0,-3197803580.0,3879315832,486634160,62154271,45817998.0,16336273.0,506760752107,499002120443,181068901375.0,171362036.0,
20170602,501826004106,15446395167,16501827336.0,-1055432169.0,3557897486,455808499,58337153,89162814.0,-30825661.0,505383901592,498268106620,154917393196.0,123816154.0,
20170605,502967461112,14819828169,13678371163.0,1141457006.0,3565840102,465305755,77451138,67953882.0,9497256.0,506533301214,499401621010,143906833031.0,85682739.0,
20170606,502648994421,13568761087,13887227778.0,-318466691.0,3571713693,447866841,54533856,71972770.0,-17438914.0,506220708114,499077280728,128125541635.0,66009817.0,
20170607,504951018649,21295080642,18993056414.0,2302024228.0,3388251237,414343909,65755987,99278919.0,-33522932.0,508339269886,501562767412,194273370491.0,219687800.0,
20170608,505449167298,18952224217,18454075568.0,498148649.0,3505035715,426735099,67177377,54786187.0,12391190.0,508954203013,501944131583,179463283400.0,117765472.0,
20170609,504070812514,18706664816,20085019600.0,-1378354784.0,3592199771,444716537,65656792,47675354.0,17981438.0,507663012285,500478612743,181824527706.0,194140807.0,
20170612,505452993981,18015011225,16632829758.0,1382181467.0,3660929777,451987256,56335769,49065050.0,7270719.0,509113923758,501792064204,170175632275.0,140856131.0,
20170613,506886152863,16110552209,14677393327.0,1433158882.0,3409027197,432570511,53929565,73346310.0,-19416745.0,510295180060,503477125666,148546328808.0,151011184.0,
20170614,507249153818,16798046853,16435045898.0,363000955.0,3350887021,441065903,81079264,72583872.0,8495392.0,510600040839,503898266797,160797740345.0,140339130.0,
20170615,509014686250,17179533078,15414000646.0,1765532432.0,3252054614,416501667,58364709,82928945.0,-24564236.0,512266740864,505762631636,171324251321.0,120048661.0,
20170616,507198520290,14650312612,16466478572.0,-1816165960.0,3246556042,414807682,59247205,60941190.0,-1693985.0,510445076332,503951964248,149447095100.0,157310530.0,
20170619,508226930204,16232669045,15204259131.0,1028409914.0,3416889249,426831377,71546606,59522911.0,12023695.0,511643819453,504810040955,152022143928.0,118288348.0,
20170620,508333054879,17080691207,16974566532.0,106124675.0,3358812434,419397848,61152261,68585790.0,-7433529.0,511691867313,504974242445,162521848822.0,107393310.0,
20170621,508932378843,18008268671,17408944707.0,599323964.0,3458382285,439057871,77624556,57964533.0,19660023.0,512390761128,505473996558,167239966570.0,121844971.0,
20170622,509754526622,25381397798,24559250019.0,822147779.0,3679412004,459116739,82011037,61952169.0,20058868.0,513433938626,506075114618,220381967294.0,250521120.0,
20170623,507890577040,18637892129,20501841711.0,-1863949582.0,3434845727,415242201,50993695,94868233.0,-43874538.0,511325422767,504455731313,175985983764.0,194722462.0,
20170626,511001191807,24254723706,21144108939.0,3110614767.0,3615355659,436162084,63454086,42534203.0,20919883.0,514616547466,507385836148,200506469618.0,224888499.0,
20170627,511457728296,19127295534,18670759045.0,456536489.0,3659056301,434703015,64898977,66358046.0,-1459069.0,515116784597,507798671995,168149944903.0,157252048.0,
20170628,513378917370,19369329421,17448140347.0,1921189074.0,3745049046,444232943,85900469,76370541.0,9529928.0,517123966416,509633868324,162569546295.0,102669843.0,
20170629,513501965352,17037839509,16914791527.0,123047982.0,3668495146,434162777,75301950,85372116.0,-10070166.0,517170460498,509833470206,148276770123.0,159376854.0,
20170630,511528278042,14427929374,16401616684.0,-1973687310.0,3330077479,396494485,37369552,75037844.0,-37668292.0,514858355521,508198200563,144074015493.0,153303005.0,
20170703,512479572751,17371993384,16420698675.0,951294709.0,3194858156,389877960,38596841,45213366.0,-6616525.0,515674430907,509284714595,156779500295.0,124652573.0,
20170704,513157610530,17950741207,17272703428.0,678037779.0,3485847272,409436897,59544318,39985381.0,19558937.0,516643457802,509671763258,161617733727.0,142384392.0,
20170705,514487818603,19417095332,18086887259.0,1330208073.0,3380513092,407039229,58945285,61342953.0,-2397668.0,517868331695,511107305511,173809359721.0,186102398.0,
20170706,514569648233,22940149474,22858319844.0,81829630.0,3701107459,439656585,71571363,38954007.0,32617356.0,518270755692,510868540774,202146091655.0,221332424.0,
20170707,513724680300,21183754356,22028722289.0,-844967933.0,3423148313,420009815,52979219,72625989.0,-19646770.0,517147828613,510301531987,201879993627.0,192766733.0,
20170710,515392194701,25753060357,24085545956.0,1667514401.0,3533303823,436142267,67990356,51857904.0,16132452.0,518925498524,511858890878,222574397000.0,269168758.0,
20170711,515329239075,24113515410,24176471036.0,-62955626.0,3652257545,465271857,89902771,60773181.0,29129590.0,518981496620,511676981530,206626986361.0,216854672.0,
20170712,515930473901,24077229893,23475995067.0,601234826.0,3674563887,451208565,69123264,83186556.0,-14063292.0,519605037788,512255910014,202012578888.0,174207110.0,
20170713,517301034702,26124408643,24753847842.0,1370560801.0,3920547029,465139197,83985652,70055020.0,13930632.0,521221581731,513380487673,210745879260.0,190045248.0,
20170714,515043617427,19950483266,22207900541.0,-2257417275.0,3732434542,449085041,55274211,71328367.0,-16054156.0,518776051969,511311182885,174634679651.0,115134408.0,
20170717,513668732540,31415272249,32790157136.0,-1374884887.0,3921384435,486076940,102895531,65903632.0,36991899.0,517590116975,509747348105,274540595272.0,337774352.0,
20170718,513938473137,22721068351,22451327754.0,269740597.0,3630727039,448380362,59196595,96893173.0,-37696578.0,517569200176,510307746098,197505186942.0,172899633.0,
20170719,516645095697,33265674928,30559052368.0,2706622560.0,3861512433,481869654,97240795,63751503.0,33489292.0,520506608130,512783583264,270506358727.0,300487258.0,
20170720,516852513732,29596930867,29389512832.0,207418035.0,3835233677,472290910,67664070,77242814.0,-9578744.0,520687747409,513017280055,246083482859.0,194373536.0,
20170721,516927360025,26921358014,26846511721.0,74846293.0,3664013338,458057261,55729000,69962649.0,-14233649.0,520591373363,513263346687,222393870689.0,217453439.0,
20170724,521007125367,31436994720,27357229378.0,4079765342.0,3819562298,479277623,75105656,53885294.0,21220362.0,524826687665,517187563069,251636221409.0,241061926.0,
20170725,523213040701,26338233274,24132317940.0,2205915334.0,3843321662,483244526,79139914,75173011.0,3966903.0,527056362363,519369719039,213542229778.0,146265615.0,
20170726,525088165155,28506278901,26631154447.0,1875124454.0,3726364371,462576384,69221980,89890122.0,-20668142.0,528814529526,521361800784,229089882452.0,149309415.0,
20170727,526393111133,28928422645,27623476667.0,1304945978.0,3672126096,456019797,74871485,81428072.0,-6556587.0,530065237229,522720985037,243236386660.0,238576265.0,
20170728,524828764794,23129529881,24693876220.0,-1564346339.0,3594552210,449456313,64850236,71413720.0,-6563484.0,528423317004,521234212584,198899672395.0,293724076.0,
20170731,528537955376,32291507628,28582317046.0,3709190582.0,3749653632,471633144,88647581,66470750.0,22176831.0,532287609008,524788301744,253685274944.0,251296740.0,
20170801,529231018478,31492038816,30798975714.0,693063102.0,3916761485,475180744,84229334,80681734.0,3547600.0,533147779963,525314256993,256421280113.0,284246284.0,
20170802,532200383095,35890923633,32921559016.0,2969364617.0,3831086862,472065238,74644104,77759610.0,-3115506.0,536031469957,528369296233,279792044472.0,224895770.0,
20170803,534879944654,30336073067,27656511508.0,2679561559.0,3530499040,426925095,40101614,85241757.0,-45140143.0,538410443694,531349445614,243765409744.0,195311684.0,
20170804,532820207518,34969999502,37029736638.0,-2059737136.0,3598484776,437008131,61343935,51260899.0,10083036.0,536418692294,529221722742,285782857257.0,201935331.0,
20170807,535636198766,29644034898,26828043650.0,2815991248.0,3544692781,435091290,59775062,61691903.0,-1916841.0,539180891547,532091505985,231829298817.0,135736151.0,
20170808,534726199658,31299192096,32209191204.0,-909999108.0,3722134478,462236088,83054330,55909532.0,27144798.0,538448334136,531004065180,255913363629.0,164541411.0,
20170809,537368647820,30620320769,27977872607.0,2642448162.0,3779979746,463123550,70474767,69587305.0,887462.0,541148627566,533588668074,237843579127.0,194067795.0,
20170810,537669007398,30265906808,29965547230.0,300359578.0,3739686127,464690682,92464047,90896915.0,1567132.0,541408693525,533929321271,251813799645.0,234803111.0,
20170811,535356477158,31093642271,33406172511.0,-2312530240.0,3531912151,436962483,78369366,106097565.0,-27728199.0,538888389309,531824565007,266766439312.0,314537237.0,
20170814,537632596431,26457875922,24181756649.0,2276119273.0,3559045374,431989793,75469867,80442557.0,-4972690.0,541191641805,534073551057,209036900678.0,223629102.0,
20170815,539648893071,24658227869,22641931229.0,2016296640.0,3796690082,475226886,111023637,67786544.0,43237093.0,543445583153,535852202989,204817778275.0,172683715.0,
20170816,540868472055,24284974967,23065395983.0,1219578984.0,3705165383,468887425,71078675,77418136.0,-6339461.0,544573637438,537163306672,200966239589.0,185838868.0,
20170817,542899045178,29645958008,27615384885.0,2030573123.0,3873410862,477987355,85823074,76723144.0,9099930.0,546772456040,539025634316,228227300628.0,215866695.0,
20170818,541748509333,25742169645,26892705490.0,-1150535845.0,3671141815,451386830,59752774,86353299.0,-26600525.0,545419651148,538077367518,218362532890.0,229070122.0,
20170821,543592415590,25636299098,23792392841.0,1843906257.0,3497726367,440823957,51042065,61604938.0,-10562873.0,547090141957,540094689223,209662844854.0,226504086.0,
20170822,544897323822,26957110928,25652202696.0,1304908232.0,3707097560,458106227,62929229,45646959.0,17282270.0,548604421382,541190226262,223745558136.0,180596571.0,
20170823,545507089335,25055341612,24445576099.0,609765513.0,3675940145,462025804,56642185,52722608.0,3919577.0,549183029480,541831149190,204316783333.0,138927654.0,
20170824,546833583828,21677814495,20351320002.0,1326494493.0,3723296900,486335871,75922014,51611947.0,24310067.0,550556880728,543110286928,186474806731.0,184985474.0,
20170825,546054164590,26559491663,27338910901.0,-779419238.0,3733950169,474496552,106115480,117954799.0,-11839319.0,549788114759,542320214421,226985904350.0,253671813.0,
20170828,550835572748,38739064545,33957656387.0,4781408158.0,4060209017,510696772,128456276,92256056.0,36200220.0,554895781765,546775363731,306133706204.0,319254268.0,
20170829,553270011460,31750813945,29316375233.0,2434438712.0,3787373917,459609720,73107712,124194764.0,-51087052.0,557057385377,549482637543,270062989946.0,217972663.0,
20170830,554844843413,34243309804,32668477851.0,1574831953.0,3938428820,496662229,113980168,76927659.0,37052509.0,558783272233,550906414593,279544574130.0,361085663.0,
20170831,559118232072,32852583691,28579195032.0,4273388659.0,3729686695,456550482,73372891,113484638.0,-40111747.0,562847918767,555388545377,269090952535.0,341607811.0,
20170901,560256965769,38145742306,37007008609.0,1138733697.0,3782081767,466994763,87809515,77365234.0,10444281.0,564039047536,556474884002,313470793695.0,448395591.0,
20170904,563595774171,36864790689,33525982287.0,3338808402.0,3654909490,439030201,67574308,95538870.0,-27964562.0,567250683661,559940864681,296767714817.0,357957161.0,
20170905,564749751259,28356786574,27202809486.0,1153977088.0,3881841504,471451664,82912017,50490554.0,32421463.0,568631592763,560867909755,246267830044.0,281698183.0,
20170906,567410040920,33756191922,31095902261.0,2660289661.0,4096511043,491711558,115941833,95681939.0,20259894.0,571506551963,563313529877,263112569849.0,341462859.0,
20170907,568069058625,32232266300,31573248595.0,659017705.0,3802840643,459369706,60695141,93036993.0,-32341852.0,571871899268,564266217982,264100382057.0,379162053.0,
20170908,568868703562,28649788248,27850143311.0,799644937.0,3624195663,424878279,52202743,86694170.0,-34491427.0,572492899225,565244507899,235367958691.0,838108890.0,
20170911,573227491085,33037857460,28679069937.0,4358787523.0,3606202807,444128822,78307599,59057056.0,19250543.0,576833693892,569621288278,257735446348.0,488951203.0,
20170912,575035344655,41786864214,39979010644.0,1807853570.0,3673940363,441435522,80203908,82897208.0,-2693300.0,578709285018,571361404292,325220422026.0,425288119.0,
20170913,577341861552,28360523868,26054006971.0,2306516897.0,3722482180,457929864,86246983,69752641.0,16494342.0,581064343732,573619379372,231159010560.0,423687422.0,
20170914,579539655735,32442812362,30245018179.0,2197794183.0,3846801704,457064747,82227079,83092196.0,-865117.0,583386457439,575692854031,256932620324.0,568641513.0,
20170915,578583374441,30565680178,31521961472.0,-956281294.0,3561335007,417519900,57302273,96847120.0,-39544847.0,582144709448,575022039434,252525457579.0,504127602.0,
20170918,582455107684,28778714421,24906981178.0,3871733243.0,3533098118,421633992,60464372,56350280.0,4114092.0,585988205802,578922009566,228385100737.0,282773510.0,
20170919,583732774712,28638406338,27360739310.0,1277667028.0,3612825172,432952665,72239527,60920854.0,11318673.0,587345599884,580119949540,220744752777.0,244116602.0,
20170920,587035104718,29680262317,26377932311.0,3302330006.0,3569458018,427909653,63043990,68087002.0,-5043012.0,590604562736,583465646700,227193439525.0,348563212.0,
20170921,586141235549,28857980931,29751850100.0,-893869169.0,3735971641,476958094,116527478,67479037.0,49048441.0,589877207190,582405263908,231980099729.0,409599840.0,
20170922,583454267943,24426309561,27113277167.0,-2686967606.0,3489006367,434666915,69237805,111528984.0,-42291179.0,586943274310,579965261576,206892535333.0,262979276.0,
20170925,581184044380,22333478459,24603702022.0,-2270223563.0,3531429126,432002233,68455185,71119867.0,-2664682.0,584715473506,577652615254,202547676763.0,410589018.0,
20170926,579908899222,17279179734,18554324892.0,-1275145158.0,3618066101,446552178,83655178,69105233.0,14549945.0,583526965323,576290833121,159546731366.0,231839388.0,
20170927,579523451666,20346208626,20731656182.0,-385447556.0,3449274798,421754694,63125694,87923178.0,-24797484.0,582972726464,576074176868,169424371788.0,308029307.0,
20170928,578224273633,20793760783,22092938816.0,-1299178033.0,3390141010,409865399,51576802,63466097.0,-11889295.0,581614414643,574834132623,184351090769.0,228352826.0,
20170929,570083581576,18403774027,26544466084.0,-8140692057.0,3063587903,360100589,14008866,63773676.0,-49764810.0,573147169479,567019993673,176182047877.0,277815732.0,
20171009,578682092143,32575427391,23976916824.0,8598510567.0,3416567962,419667372,80668836,21102053.0,59566783.0,582098660105,575265524181,227197351495.0,468748379.0,
20171010,583145677767,29129605458,24666019834.0,4463585624.0,3447916434,406623289,66838440,79882523.0,-13044083.0,586593594201,579697761333,231450355656.0,301828209.0,
20171011,583522843846,25301765202,24924599123.0,377166079.0,3614850268,470018575,124366436,60971150.0,63395286.0,587137694114,579907993578,231503778940.0,264204692.0,
20171012,583464735903,23778972170,23837080113.0,-58107943.0,3823521864,493796248,140285712,116508039.0,23777673.0,587288257767,579641214039,202250334189.0,436850135.0,
20171013,582562628235,19444343723,20346451391.0,-902107668.0,3411703160,431852830,83506576,145449994.0,-61943418.0,585974331395,579150925075,181551241029.0,183190643.0,
20171016,583759038774,26676245565,25479835026.0,1196410539.0,3498468733,419469982,76783181,89166029.0,-12382848.0,587257507507,580260570041,221665338178.0,275631617.0,
20171017,584023686833,17522502561,17257854502.0,264648059.0,3427935444,431429615,82068337,70108704.0,11959633.0,587451622277,580595751389,163097065995.0,366372491.0,
20171018,581592266640,20201858871,22633279064.0,-2431420193.0,3601203661,437022324,81025125,75432416.0,5592709.0,585193470301,577991062979,194962102654.0,286054998.0,
20171019,579306498080,20408730538,22694499098.0,-2285768560.0,3554960263,428037151,60065739,69050912.0,-8985173.0,582861458343,575751537817,188235218477.0,224609157.0,
20171020,578649055545,17650041440,18307483975.0,-657442535.0,3403723659,407047661,38321782,59311272.0,-20989490.0,582052779204,575245331886,155307897955.0,372107611.0,
20171023,580901689048,19180931506,16928298003.0,2252633503.0,3471614829,414476802,52887181,45458040.0,7429141.0,584373303877,577430074219,164297443772.0,273757980.0,
20171024,578877370713,18074355996,20098674331.0,-2024318335.0,3724863881,459939221,86145437,40683018.0,45462419.0,582602234594,575152506832,178519199035.0,161076633.0,
20171025,579673158365,18360283874,17564496222.0,795787652.0,3557791155,420002329,43331925,83268817.0,-39936892.0,583230949520,576115367210,160330198166.0,245487207.0,
20171026,585721846144,31351471515,25302783736.0,6048687779.0,3710445203,435375661,71269168,55895836.0,15373332.0,589432291347,582011400941,239682554301.0,330315035.0,
20171027,586980537209,26446780229,25188089164.0,1258691065.0,3595627068,420800673,46881723,61456711.0,-14574988.0,590576164277,583384910141,212590577884.0,243557085.0,
20171030,587251583104,31576733592,31305687697.0,271045895.0,3757667025,444487721,71427025,47739977.0,23687048.0,591009250129,583493916079,257597180098.0,342074222.0,
20171031,589196036713,24791626758,22847173149.0,1944453609.0,3717369343,448642962,67355998,63200757.0,4155241.0,592913406056,585478667370,200527619672.0,282844229.0,
20171101,593084233167,28705800913,24817604459.0,3888196454.0,3925298338,491601782,118625788,75666968.0,42958820.0,597009531505,589158934829,232394181429.0,220548952.0,
20171102,591938582941,23159575658,24305225884.0,-1145650226.0,3663595163,465724210,95949315,121826887.0,-25877572.0,595602178104,588274987778,210654313515.0,272967819.0,
20171103,589295810105,22065591152,24708363988.0,-2642772836.0,3643067348,465208697,99391921,99907434.0,-515513.0,592938877453,585652742757,208373181264.0,276414495.0,
20171106,593520002896,25570944919,21346752128.0,4224192791.0,3621227942,462636701,93081749,95653745.0,-2571996.0,597141230838,589898774954,204496754705.0,237325506.0,
20171107,597686940879,30488210444,26321272461.0,4166937983.0,3999307696,512034410,137849313,88451604.0,49397709.0,601686248575,593687633183,242896795612.0,222654336.0,
20171108,599847626587,29447070709,27286385001.0,2160685708.0,3774348734,456821400,80880444,136093454.0,-55213010.0,603621975321,596073277853,242711393956.0,237959202.0,
20171109,602292882328,26156935189,23711679448.0,2445255741.0,3781100207,454744258,72398883,74476025.0,-2077142.0,606073982535,598511782121,208073903104.0,308831681.0,
20171110,602677946214,32745721664,32360657778.0,385063886.0,3821670534,438506907,59189014,75426365.0,-16237351.0,606499616748,598856275680,256048285795.0,238041153.0,
20171113,607453853482,34795444594,30019537326.0,4775907268.0,4052282858,492594068,111469783,57382622.0,54087161.0,611506136340,603401570624,266607783897.0,328230817.0,
20171114,609530393847,33110831866,31034291501.0,2076540365.0,4017520980,469167041,98235089,121662116.0,-23427027.0,613547914827,605512872867,267767887921.0,359866680.0,
20171115,610088191761,27322760931,26764963017.0,557797914.0,3985367896,496978150,130081113,102270004.0,27811109.0,614073559657,606102823865,239923346775.0,248100161.0,
20171116,611955170107,27540418339,25673439993.0,1866978346.0,4026241575,480631120,108925639,125272669.0,-16347030.0,615981411682,607928928532,222151919125.0,191152766.0,
20171117,605407313174,33437375721,39985232654.0,-6547856933.0,4224948523,518548935,135303417,97385602.0,37917815.0,609632261697,601182364651,313928248339.0,362976559.0,
20171120,606152968284,27606992716,26861337606.0,745655110.0,4080179520,493267595,98061706,123343046.0,-25281340.0,610233147804,602072788764,228744593492.0,261098971.0,
20171121,610896888811,35670732307,30926811780.0,4743920527.0,4232326120,502105836,104388086,95549845.0,8838241.0,615129214931,606664562691,265551771989.0,193398122.0,
20171122,613638975630,37463915477,34721828658.0,2742086819.0,4222736888,503338160,95749026,94516702.0,1232324.0,617861712518,609416238742,274616851610.0,201403289.0,
20171123,612323609647,34971820282,36287186265.0,-1315365983.0,4017733352,509514411,108387117,102210866.0,6176251.0,616341342999,608305876295,270651631607.0,238567048.0,
20171124,607803783678,22821336538,27341162507.0,-4519825969.0,3733474862,452679647,62007179,118841943.0,-56834764.0,611537258540,604070308816,209555973258.0,182292705.0,
20171127,604120318760,21706868377,25390333295.0,-3683464918.0,3748916832,458580752,78489295,72588190.0,5901105.0,607869235592,600371401928,206302390710.0,176392366.0,
20171128,605038393589,20423735751,19505660922.0,918074829.0,3664336812,440829702,61488883,79239933.0,-17751050.0,608702730401,601374056777,168253832300.0,141153891.0,
20171129,606435086718,27404524134,26007831005.0,1396693129.0,4057232251,499783242,121540529,62586989.0,58953540.0,610492318969,602377854467,218124302688.0,185750750.0,
20171130,606266729261,23568646067,23737003524.0,-168357457.0,3882969879,478233162,96504247,118054327.0,-21550080.0,610149699140,602383759382,192367075700.0,212856611.0,
20171201,605049876092,20725355751,21942208920.0,-1216853169.0,3655974771,443732783,63388333,97888712.0,-34500379.0,608705850863,601393901321,178940840531.0,112736048.0,
20171204,604595733465,20604878464,21059021091.0,-454142627.0,3754415327,458436496,86365562,71661849.0,14703713.0,608350148792,600841318138,185115468892.0,145654116.0,
20171205,594960743028,20791260681,30426251118.0,-9634990437.0,3839705056,474532056,92330721,76235161.0,16095560.0,598800448084,591121037972,244740475799.0,260658555.0,
20171206,595236819307,21596035758,21319959479.0,276076279.0,3692154268,460401742,77544558,91674872.0,-14130314.0,598928973575,591544665039,179546586530.0,186843731.0,
20171207,596091122261,19581499313,18727196359.0,854302954.0,3554247048,440694265,64305058,84012535.0,-19707477.0,599645369309,592536875213,162480562143.0,102080306.0,
20171208,595997613220,19042969089,19136478130.0,-93509041.0,3599879327,470332997,101508401,71869669.0,29638732.0,599597492547,592397733893,165969246695.0,126674423.0,
20171211,597388285945,20461557664,19070884939.0,1390672725.0,3758638299,486613322,110323326,94043001.0,16280325.0,601146924244,593629647646,173567044406.0,134054561.0,
20171212,598121141086,20096147911,19363292770.0,732855141.0,3750354277,511091337,118763206,94285191.0,24478015.0,601871495363,594370786809,161158413684.0,114896064.0,
20171213,599823623298,18141605058,16439122846.0,1702482212.0,3806754508,501834433,113866925,123123829.0,-9256904.0,603630377806,596016868790,145954601940.0,136717655.0,
20171214,601518600419,19549257497,17854280376.0,1694977121.0,4002821102,533469985,144729254,113093702.0,31635552.0,605521421521,597515779317,152077562639.0,91897493.0,
20171215,599973160706,17498770920,19044210633.0,-1545439713.0,3650059277,482057036,97333253,148746202.0,-51412949.0,603623219983,596323101429,162917897464.0,173216290.0,
20171218,600385416902,16374411672,15962155476.0,412256196.0,3706518967,483998594,99663217,97721659.0,1941558.0,604091935869,596678897935,150208062596.0,119311553.0,
20171219,601150771777,17601240193,16835885318.0,765354875.0,3729730482,454713106,72507997,101793485.0,-29285488.0,604880502259,597421041295,151960783161.0,87744678.0,
20171220,600660765121,20341227305,20831233961.0,-490006656.0,3804967455,481084040,89601083,63230149.0,26370934.0,604465732576,596855797666,169502609752.0,82945966.0,
20171221,601331057847,21436735962,20766443236.0,670292726.0,3828819296,497390836,109017640,92710844.0,16306796.0,605159877143,597502238551,175049093047.0,130281787.0,
20171222,600752458618,17813164425,18391763654.0,-578599229.0,3720772560,486351525,63490251,74529562.0,-11039311.0,604473231178,597031686058,154233498632.0,75496037.0,
20171225,602010826133,20835295949,19576928434.0,1258367515.0,3999879905,522512747,115968844,79807622.0,36161222.0,606010706038,598010946228,180121895185.0,101880774.0,
20171226,603788870421,19751644607,17973600319.0,1778044288.0,3779155598,475931044,72584885,119166588.0,-46581703.0,607568026019,600009714823,176145068604.0,94975512.0,
20171227,604243378239,23203488414,22748980596.0,454507818.0,3614363807,445727861,80882761,111085944.0,-30203183.0,607857742046,600629014432,202176875408.0,137618190.0,
20171228,607288414879,25351894785,22306858145.0,3045036640.0,3777150934,478803994,109419427,76343294.0,33076133.0,611065565813,603511263945,211965581290.0,162054901.0,
20171229,605281700426,19021641781,21028356234.0,-2006714453.0,3584861409,450271299,57296261,85828956.0,-28532695.0,608866561835,601696839017,175469498075.0,116636763.0,
20180102,608366051878,27590480172,24506128720.0,3084351452.0,3654085132,441452197,76344279,85163381.0,-8819102.0,612020137010,604711966746,227924026066.0,177060675.0,
20180103,608815534517,30439570182,29990087543.0,449482639.0,3772954586,448392069,74917924,67978052.0,6939872.0,612588489103,605042579931,258510773503.0,212482702.0,
20180104,610527948195,29696616884,27984203206.0,1712413678.0,3955106395,473343923,81062102,56110248.0,24951854.0,614483054590,606572841800,243231440746.0,169633080.0,
20180105,611033498008,30311498312,29805948499.0,505549813.0,3909520577,475185679,72649378,70807622.0,1841756.0,614943018585,607123977431,248362194302.0,184882100.0,
20180108,614437310945,36490715414,33086902477.0,3403812937.0,4207633747,520467167,104853368,59571880.0,45281488.0,618644944692,610229677198,287061462429.0,276297698.0,
20180109,616540107796,30086145554,27983348703.0,2102796851.0,4077347539,492605694,69350546,97212019.0,-27861473.0,620617455335,612462760257,239316463093.0,137042655.0,
20180110,619625092233,33230513439,30145529002.0,3084984437.0,4205771294,515254713,88968220,66319201.0,22649019.0,623830863527,615419320939,255083767528.0,186782555.0,
20180111,621046744130,28156920753,26735268856.0,1421651897.0,4177520514,518981283,85734540,82007970.0,3726570.0,625224264644,616869223616,218858053005.0,177811372.0,
20180112,619848249343,26368470723,27566965510.0,-1198494787.0,4093318611,506595130,80954815,93340968.0,-12386153.0,623941567954,615754930732,216133659773.0,178687904.0,
20180115,621497637591,36278584789,34629196541.0,1649388248.0,4379791823,569752152,132724788,69567766.0,63157022.0,625877429414,617117845768,286605727718.0,231682012.0,
20180116,625992542194,34078228867,29583324264.0,4494904603.0,4133975739,503553012,74508764,140707904.0,-66199140.0,630126517933,621858566455,267327332596.0,190159244.0,
20180117,627094987907,39842179516,38739733803.0,1102445713.0,4454773086,567252405,138072735,74373342.0,63699393.0,631549760993,622640214821,316846472348.0,192146411.0,
20180118,634228438561,36979327828,29845877174.0,7133450654.0,4477045539,552058099,103608937,118803243.0,-15194306.0,638705484100,629751393022,267689709997.0,160790836.0,
20180119,636018905560,37339370592,35548903593.0,1790466999.0,4378780910,554563499,105099649,102594249.0,2505400.0,640397686470,631640124650,295210986996.0,176265407.0,
20180122,639921300534,33237544268,29335149294.0,3902394974.0,4354081581,542599432,87925167,99889234.0,-11964067.0,644275382115,635567218953,263218649715.0,239871931.0,
20180123,644564213418,37876068321,33233155437.0,4642912884.0,4455055561,540815711,86183139,87966860.0,-1783721.0,649019268979,640109157857,282172348247.0,244581920.0,
20180124,646859187212,42616129855,40321156061.0,2294973794.0,4448193750,542170310,98229541,96874942.0,1354599.0,651307380962,642410993462,311723899108.0,214622350.0,
20180125,647529134317,38141340740,37471393635.0,669947105.0,4381538742,533190722,95255666,104235254.0,-8979588.0,651910673059,643147595575,289203093399.0,316692443.0,
20180126,646634615949,34247168309,35141686677.0,-894518368.0,4269286836,516847971,76289213,92631964.0,-16342751.0,650903902785,642365329113,258306564473.0,163746882.0,
20180129,648256047965,38181209245,36559777229.0,1621432016.0,4192740627,501055416,71491288,87283843.0,-15792555.0,652448788592,644063307338,286666904758.0,298351611.0,
20180130,648176166579,28745206171,28825087557.0,-79881386.0,4058242338,478033248,60408630,83430798.0,-23022168.0,652234408917,644117924241,225161992308.0,186210518.0,
20180131,645400680690,28966225507,31741711396.0,-2775485889.0,4054638580,483571589,73671246,68132905.0,5538341.0,649455319270,641346042110,242507068703.0,244546158.0,
20180201,636482319607,29702648663,38621009746.0,-8918361083.0,4233708630,502463110,79415607,60524086.0,18891521.0,640716028237,632248610977,293553736763.0,447670549.0,
20180202,631035437334,27287974198,32734856471.0,-5446882273.0,4042598212,473192696,56031475,85301889.0,-29270414.0,635078035546,626992839122,236741914081.0,354275265.0,
20180205,630054975768,29843195422,30823656988.0,-980461566.0,4322740448,514623809,104110875,62679762.0,41431113.0,634377716216,625732235320,252580012752.0,223958965.0,
20180206,619290275865,31544870755,42309570658.0,-10764699903.0,4188948545,510319945,96446231,100750095.0,-4303864.0,623479224410,615101327320,318645881025.0,435012085.0,
20180207,616405478519,35263849592,38148646938.0,-2884797346.0,4007914605,489860104,95806694,116266535.0,-20459841.0,620413393124,612397563914,295685221369.0,303244903.0,
20180208,615710148081,25870067541,26565397979.0,-695330438.0,3785537067,466231986,80582428,104210546.0,-23628118.0,619495685148,611924611014,224645828502.0,244580649.0,
20180209,604833557210,27580819000,38457409871.0,-10876590871.0,3573356841,466193240,104990562,105029308.0,-38746.0,608406914051,601260200369,273745976046.0,413127684.0,
20180212,600926938548,16839248965,20745867627.0,-3906618662.0,3754839053,481391892,100772812,85574160.0,15198652.0,604681777601,597172099495,170981267224.0,196699957.0,
20180213,595328087592,16338479817,21937330773.0,-5598850956.0,3824705594,481300156,72708581,72800317.0,-91736.0,599152793186,591503381998,172279298212.0,184870466.0,
20180214,587596708400,9746397185,17477776377.0,-7731379192.0,3390879358,428137439,38697420,91860137.0,-53162717.0,590987587758,584205829042,114505876771.0,119528585.0,
20180222,590374192560,19397930848,16620446688.0,2777484160.0,4218365813,537231638,141429804,32335605.0,109094199.0,594592558373,586155826747,157311179734.0,186339719.0,
20180223,590318411364,17836336744,17892117940.0,-55781196.0,4279690057,538441060,80715203,79505781.0,1209422.0,594598101421,586038721307,159407037956.0,165396558.0,
20180226,592714977109,25753904633,23357338888.0,2396565745.0,4324525319,539766801,97710691,96384950.0,1325741.0,597039502428,588390451790,213263928463.0,188992669.0,
20180227,593011785899,22856603849,22559795059.0,296808790.0,4210700362,515507218,74280906,98540489.0,-24259583.0,597222486261,588801085537,206539999752.0,225688823.0,
20180228,594617162664,21297493208,19692116443.0,1605376765.0,4152781574,519612772,90028782,85923228.0,4105554.0,598769944238,590464381090,180362492634.0,212547896.0,
20180301,595939917864,20597765093,19275009893.0,1322755200.0,4026257637,502779091,81985449,98819130.0,-16833681.0,599966175501,591913660227,185355100270.0,260527404.0,
20180302,595361568569,19133250564,19711599859.0,-578349295.0,3842126390,483333284,65974083,85419890.0,-19445807.0,599203694959,591519442179,178635170188.0,170361172.0,
20180305,595049930410,18212115131,18523753290.0,-311638159.0,3948000137,513243849,87456226,57545661.0,29910565.0,598997930547,591101930273,174170048833.0,197493487.0,
20180306,597537104191,27621735488,25134561707.0,2487173781.0,4228810764,527135417,120845036,106953468.0,13891568.0,601765914955,593308293427,224510901461.0,208707221.0,
20180307,596969079947,21333658687,21901682931.0,-568024244.0,4372211579,576301732,142019595,92853280.0,49166315.0,601341291526,592596868368,194241692969.0,125253415.0,
20180308,597940210780,19508623178,18537492345.0,971130833.0,4143832074,513988371,80078000,142391361.0,-62313361.0,602084042854,593796378706,176296304463.0,93762122.0,
20180309,597050145863,22987739737,23877804654.0,-890064917.0,4172074169,517673800,85716362,82030933.0,3685429.0,601222220032,592878071694,203566188750.0,170152901.0,
20180312,600045856188,30147045291,27151334966.0,2995710325.0,4192577698,499347672,92955878,111282006.0,-18326128.0,604238433886,595853278490,248279233037.0,331085318.0,
20180313,599568767827,23243312776,23720401137.0,-477088361.0,3983416506,482696631,83299271,99950312.0,-16651041.0,603552184333,595585351321,202734145790.0,179207749.0,
20180314,600345441237,21844321789,21067648379.0,776673410.0,3963230726,478003419,86252615,90945827.0,-4693212.0,604308671963,596382210511,184031993483.0,185177119.0,
20180315,601172365606,20560258426,19733334057.0,826924369.0,4072190209,513327141,101371412,66047690.0,35323722.0,605244555815,597100175397,179551078080.0,162138717.0,
20180316,600603525889,19655255713,20224095430.0,-568839717.0,3832651624,477923762,70720573,106123952.0,-35403379.0,604436177513,596770874265,167829477485.0,229801742.0,
20180319,601576470724,19786309333,18813364498.0,972944835.0,4072476369,521595800,115183057,71511019.0,43672038.0,605648947093,597503994355,170206515112.0,199704328.0,
20180320,602106366122,19071274527,18541379129.0,529895398.0,4011255918,503405374,90705615,108896041.0,-18190426.0,606117622040,598095110204,167549368524.0,182158847.0,
20180321,603579457196,24618884450,23145793376.0,1473091074.0,4183191496,524294541,113223929,92334762.0,20889167.0,607762648692,599396265700,209939654899.0,182501040.0,
20180322,603796655509,19824211088,19607012775.0,217198313.0,3894306402,487482347,87921061,124733255.0,-36812194.0,607690961911,599902349107,185070345922.0,146130366.0,
20180323,593792703708,25850609555,35854561356.0,-10003951801.0,3855268470,512844402,134572126,109210071.0,25362055.0,597647972178,589937435238,294096077436.0,392006941.0,
20180326,597411337395,24175340823,20556707136.0,3618633687.0,3755175967,483055245,108943854,138733011.0,-29789157.0,601166513362,593656161428,216734233360.0,168534679.0,
20180327,599442144212,25598099415,23567292598.0,2030806817.0,3910564069,497645258,109508379,94918366.0,14590013.0,603352708281,595531580143,229138867119.0,178687040.0,
20180328,599307494218,21615504204,21750154198.0,-134649994.0,4001345465,538455045,131261267,90451480.0,40809787.0,603308839683,595306148753,209730207757.0,99877495.0,
20180329,600145215249,24031744677,23194023646.0,837721031.0,4173749355,539998095,130956766,129413716.0,1543050.0,604318964604,595971465894,210971916079.0,157639595.0,
20180330,598855912677,21090897971,22380200543.0,-1289302572.0,4064850235,501625650,75362505,113734950.0,-38372445.0,602920762912,594791062442,197482840518.0,149393393.0,
20180402,601030714928,26034092292,23859290041.0,2174802251.0,4206509899,545886858,114597342,70336134.0,44261208.0,605237224827,596824205029,226359957274.0,143850395.0,
20180403,601169419027,19661769790,19523065691.0,138704099.0,3950267728,500961705,72416614,117341767.0,-44925153.0,605119686755,597219151299,189848258249.0,132741521.0,
20180404,598181552536,19443610928,22431477419.0,-2987866491.0,3819740711,489696634,64327859,75592930.0,-11265071.0,602001293247,594361811825,193776269514.0,119801176.0,
20180409,599650337034,19593413352,18124628854.0,1468784498.0,3990578093,525219014,92769980,57247600.0,35522380.0,603640915127,595659758941,179567910171.0,130710824.0,
20180410,599080845943,21979137912,22548629003.0,-569491091.0,4362450284,578424038,139240721,86035697.0,53205024.0,603443296227,594718395659,206691481305.0,148810478.0,
20180411,599689679276,22023899412,21415066079.0,608833333.0,4396595995,568770358,91789260,101442940.0,-9653680.0,604086275271,595293083281,211723346303.0,145389988.0,
20180412,600424988033,18548690772,17813382015.0,735308757.0,4234501220,547550452,58490691,79710597.0,-21219906.0,604659489253,596190486813,185217592001.0,97689473.0,
20180413,599833935982,16441860274,17032912325.0,-591052051.0,4227629771,551694653,73493670,69349469.0,4144201.0,604061565753,595606306211,163830330326.0,133100705.0,
20180416,601024882857,20552602328,19361655453.0,1190946875.0,4284273761,579311344,104403224,76786533.0,27616691.0,605309156618,596740609096,194118341784.0,185135131.0,
20180417,600284382263,18703544217,19444044811.0,-740500594.0,4090618073,553977154,93695430,119029620.0,-25334190.0,604375000336,596193764190,185592576680.0,135614334.0,
20180418,600098082128,20640351247,20826651382.0,-186300135.0,4211713806,572480773,121604143,103100524.0,18503619.0,604309795934,595886368322,203040450692.0,209678893.0,
20180419,599180521526,20126295238,21043855840.0,-917560602.0,4345560275,575995599,100439088,96924262.0,3514826.0,603526081801,594834961251,196315489413.0,125915309.0,
20180420,596545372671,18648208020,21283356875.0,-2635148855.0,4227127835,578160438,97231955,95067116.0,2164839.0,600772500506,592318244836,186568564655.0,120229344.0,
20180423,596995595435,17269095574,16818872810.0,450222764.0,4153763852,577099428,86147091,87208101.0,-1061010.0,601149359287,592841831583,158174551297.0,133094341.0,
20180424,596377635708,20668951583,21286911310.0,-617959727.0,4297552965,578747468,102620337,100972297.0,1648040.0,600675188673,592080082743,196116472824.0,145709199.0,
20180425,597019402304,17402108733,16760342137.0,641766596.0,4191882772,556651252,66085362,88181578.0,-22096216.0,601211285076,592827519532,161725614710.0,97790864.0,
20180426,596178122764,17853488136,18694767676.0,-841279540.0,4068722777,546411881,61633457,71872828.0,-10239371.0,600246845541,592109399987,165234808566.0,79816011.0,
20180427,592867415552,18335751591,21646458803.0,-3310707212.0,3973500134,530572059,61458180,77298002.0,-15839822.0,596840915686,588893915418,179785705456.0,113396700.0,
20180502,592911559958,17814502974,17770358568.0,44144406.0,4128773924,576827570,99870623,53615112.0,46255511.0,597040333882,588782786034,168802735157.0,114405449.0,
20180503,591987078108,17460205873,18384687723.0,-924481850.0,4185001993,559667856,84167918,101327632.0,-17159714.0,596172080101,587802076115,173879292717.0,116864741.0,
20180504,590434735762,15158223349,16710565695.0,-1552342346.0,4228599065,586810896,98736108,71593068.0,27143040.0,594663334827,586206136697,149379407018.0,71123901.0,
20180507,591629638695,19854191481,18659288548.0,1194902933.0,4410626492,588025721,100528562,99313737.0,1214825.0,596040265187,587219012203,178879409214.0,144343102.0,
20180508,592400524194,20998883416,20227997917.0,770885499.0,4722284750,662332921,149281168,74973968.0,74307200.0,597122808944,587678239444,189660277687.0,123847534.0,
20180509,593703956355,16553893663,15250461502.0,1303432161.0,4444716543,606024654,84683609,140991876.0,-56308267.0,598148672898,589259239812,154253709248.0,100594735.0,
20180510,594735071550,18640720276,17609605081.0,1031115195.0,4548945214,616132570,85473140,75365224.0,10107916.0,599284016764,590186126336,166099454116.0,136754648.0,
20180511,592719427747,17227451352,19243095155.0,-2015643803.0,4392449312,603532099,74526602,87127073.0,-12600471.0,597111877059,588326978435,167742005649.0,106313014.0,
20180514,592905263679,17647263423,17461427491.0,185835932.0,4573646168,613708054,86415258,76239303.0,10175955.0,597478909847,588331617511,173160464557.0,146135373.0,
20180515,593410196752,16843274130,16338341057.0,504933073.0,4605082468,615080747,78345394,76972701.0,1372693.0,598015279220,588805114284,163199432023.0,148743620.0,
20180516,594416330170,18589326461,17583193043.0,1006133418.0,4596491045,624035744,82670037,73715040.0,8954997.0,599012821215,589819839125,175906359458.0,137605187.0,
20180517,595158136870,14970481628,14228674928.0,741806700.0,4453809437,609938641,74778911,88876014.0,-14097103.0,599611946307,590704327433,150829221093.0,150520193.0,
20180518,594145598040,17450293668,18462832498.0,-1012538830.0,4611049856,623244085,90639341,77333897.0,13305444.0,598756647896,589534548184,169023827955.0,158267971.0,
20180521,595880340436,22954339139,21219596743.0,1734742396.0,4774908811,639878127,91042411,74408369.0,16634042.0,600655249247,591105431625,203170886284.0,152458677.0,
20180522,597985960989,20130655107,18025034554.0,2105620553.0,4738431993,627590561,66217588,78505154.0,-12287566.0,602724392982,593247528996,186318559833.0,81054442.0,
20180523,599797085094,20767927369,18956803264.0,1811124105.0,4664544356,620918898,62945590,69617253.0,-6671663.0,604461629450,595132540738,200860003721.0,145283741.0,
20180524,600564172688,16063644818,15296557224.0,767087594.0,4648493040,626126474,58069877,52862301.0,5207576.0,605212665728,595915679648,161876449047.0,153423794.0,
20180525,598455827921,15692437026,17800781793.0,-2108344767.0,4599410124,621890648,53232829,57468655.0,-4235826.0,603055238045,593856417797,167457459625.0,229314824.0,
20180528,598949037435,16829970023,16336760509.0,493209514.0,4694646611,637365163,55866482,40391967.0,15474515.0,603643684046,594254390824,168258374252.0,171334525.0,
20180529,597965012117,17611399398,18595424716.0,-984025318.0,4817925876,659521980,72331953,50175136.0,22156817.0,602782937993,593147086241,178855747253.0,140584422.0,
20180530,595635486365,17126411578,19455937330.0,-2329525752.0,4667892780,664925295,72201621,66798306.0,5403315.0,600303379145,590967593585,192137027838.0,268550555.0,
20180531,595372987763,16761954362,17024452964.0,-262498602.0,4846718115,678091971,73765112,60598436.0,13166676.0,600219705878,590526269648,185266633405.0,975782103.0,
20180601,592445445276,14018863627,16946406114.0,-2927542487.0,4799782262,679398928,64251426,62944469.0,1306957.0,597245227538,587645663014,166707325313.0,185521404.0,
20180604,590840188900,13965747617,15571003993.0,-1605256376.0,4899141075,697119312,76890586,59170202.0,17720384.0,595739329975,585941047825,155090090792.0,155621744.0,
20180605,591074705741,15907349459,15672832618.0,234516841.0,5049180803,693717597,64045536,67447251.0,-3401715.0,596123886544,586025524938,165192387600.0,121877798.0,
20180606,590709945434,15375328504,15740088811.0,-364760307.0,5119333953,706324292,71699058,59092363.0,12606695.0,595829279387,585590611481,163251383266.0,99856220.0,
20180607,590959804095,16991538468,16741679807.0,249858661.0,5184910940,714880103,66320004,57764193.0,8555811.0,596144715035,585774893155,168257642576.0,119166101.0,
20180608,589088015126,14348962045,16220751014.0,-1871788969.0,4922931680,687568477,60109192,87420818.0,-27311626.0,594010946806,584165083446,161503107262.0,106724644.0,
20180611,588485005458,12811528887,13414538555.0,-603009668.0,5065021647,709750001,71841306,49659782.0,22181524.0,593550027105,583419983811,143998637480.0,80532914.0,
20180612,588519533549,15173608534,15139080443.0,34528091.0,5296550864,732589169,84532721,61693553.0,22839168.0,593816084413,583222982685,154982125935.0,144103143.0,
20180613,587140793988,13060641153,14439380714.0,-1378739561.0,5164104663,721178966,70725188,82135391.0,-11410203.0,592304898651,581976689325,156605671599.0,120948959.0,
20180614,586589031060,13899414423,14451177351.0,-551762928.0,5357453951,766844975,104221319,58555310.0,45666009.0,591946485011,581231577109,148613141779.0,127087690.0,
20180615,581569561529,13870458115,18889927646.0,-5019469531.0,5203729466,761565618,82037661,87317018.0,-5279357.0,586773290995,576365832063,162567535198.0,270384577.0,
20180619,567849953722,19075444718,32795052525.0,-13719607807.0,5227368870,803183785,133522454,91904287.0,41618167.0,573077322592,562622584852,241331210510.0,324629815.0,
20180620,564645936794,14020014696,17224031624.0,-3204016928.0,4975410577,752501046,71138015,121820754.0,-50682739.0,569621347371,559670526217,157027219934.0,138517975.0,
20180621,560808688544,14801185938,18638434188.0,-3837248250.0,5173590371,810695305,115815936,57621677.0,58194259.0,565982278915,555635098173,159879362016.0,146101168.0,
20180622,558196136785,11381925807,13994477566.0,-2612551759.0,4965075587,760970157,58778229,108503377.0,-49725148.0,563161212372,553231061198,127401918902.0,125291938.0,
20180625,556875334203,11757098952,13077901534.0,-1320802582.0,5258259159,810587352,99921430,50304235.0,49617195.0,562133593362,551617075044,132357801056.0,98095480.0,
20180626,556636105493,12576291197,12815519907.0,-239228710.0,5190087507,789178423,74059593,95468522.0,-21408929.0,561826193000,551446017986,139584194937.0,117621769.0,
20180627,555886983956,13003328483,13752450020.0,-749121537.0,5380856938,841997865,115157843,62338401.0,52819442.0,561267840894,550506127018,142980576841.0,94291516.0,
20180628,555085668675,11535268881,12336584162.0,-801315281.0,5240011996,824047977,79984555,97934443.0,-17949888.0,560325680671,549845656679,132544066217.0,90466421.0,
20180629,553522416883,13029951416,14593203208.0,-1563251792.0,5436131119,819402647,99427264,104072594.0,-4645330.0,558958548002,548086285764,135619517125.0,174618270.0,
20180702,552525463016,13822745385,14819699252.0,-996953867.0,5458416822,853159487,115421849,81665009.0,33756840.0,557983879838,547067046194,147797795944.0,114532155.0,
20180703,552690105369,15247081510,15082439157.0,164642353.0,5506176897,854343505,118558812,117374794.0,1184018.0,558196282266,547183928472,161868563333.0,119069616.0,
20180704,549414701907,9905878496,13181281958.0,-3275403462.0,5493794460,867513571,100734396,87564330.0,13170066.0,554908496367,543920907447,131085277416.0,81764243.0,
20180705,546020776894,10580490356,13974415369.0,-3393925013.0,5496431511,878072509,100017594,89458656.0,10558938.0,551517208405,540524345383,133168812623.0,103635877.0,
20180706,543489414407,12896260866,15427623353.0,-2531362487.0,5537590785,877989836,100828306,100910979.0,-82673.0,549027005192,537951823622,148410371013.0,136657132.0,
20180709,542012974350,11893969265,13370409322.0,-1476440057.0,5839181315,910092256,102767274,70664854.0,32102420.0,547852155665,536173793035,135823001935.0,119136317.0,
20180710,541878346674,11889884588,12024512264.0,-134627676.0,5966656000,923428291,88033139,74697104.0,13336035.0,547845002674,535911690674,132690419149.0,105113434.0,
20180711,539487029849,11414643702,13805960527.0,-2391316825.0,5788339371,923002288,98760946,99186949.0,-426003.0,545275369220,533698690478,138303026333.0,122290703.0,
20180712,540247707295,15746282870,14985605424.0,760677446.0,5941896813,918580058,88124579,92546809.0,-4422230.0,546189604108,534305810482,170811394391.0,152882923.0,
20180713,538340528874,12579504304,14486682725.0,-1907178421.0,5820349633,904611252,68637546,82606352.0,-13968806.0,544160878507,532520179241,146442388440.0,100957636.0,
20180716,538527240085,12420489520,12233778309.0,186711211.0,5861316303,900435462,79501499,83677289.0,-4175790.0,544388556388,532665923782,129492294692.0,134511797.0,
20180717,539103125579,12094301625,11518416131.0,575885494.0,5727286398,887877888,82144955,94702529.0,-12557574.0,544830411977,533375839181,124215674809.0,85803496.0,
20180718,538559054640,13026577818,13570648757.0,-544070939.0,5811492042,899604354,84462991,72736525.0,11726466.0,544370546682,532747562598,138773719514.0,91598736.0,
20180719,536935848153,11438197205,13061403692.0,-1623206487.0,5878888200,919889220,93128766,72843900.0,20284866.0,542814736353,531056959953,129813799750.0,91724795.0,
20180720,534906513435,14671769781,16701104499.0,-2029334718.0,6136873656,935063064,102540870,87367026.0,15173844.0,541043387091,528769639779,155886901908.0,112535862.0,
20180723,534001675133,18718068986,19622907288.0,-904838302.0,6397855276,974263080,123205923,84005907.0,39200016.0,540399530409,527603819857,187489142159.0,160911656.0,
20180724,533653883014,23085285680,23433077799.0,-347792119.0,6382280611,960253394,93078625,107088311.0,-14009686.0,540036163625,527271602403,229094286815.0,179958056.0,
20180725,534356990639,16247928748,15544821123.0,703107625.0,6477483650,997355779,102713437,65611052.0,37102385.0,540834474289,527879506989,166778223517.0,104985987.0,
20180726,535637045599,15646868964,14366814004.0,1280054960.0,6388379072,968261754,81111324,110205349.0,-29094025.0,542025424671,529248666527,157774097574.0,97249683.0,
20180727,533848926644,11868522985,13656641940.0,-1788118955.0,6307997397,951447265,58855822,75670311.0,-16814489.0,540156924041,527540929247,133007481594.0,96198782.0,
20180730,533625257352,13499201549,13722870841.0,-223669292.0,6323144046,960098751,69563110,60911624.0,8651486.0,539948401398,527302113306,145935594166.0,126445391.0,
20180731,532916979958,10350154724,11058432118.0,-708277394.0,6323746312,968005836,66856262,58949177.0,7907085.0,539240726270,526593233646,119555870463.0,110797041.0,
20180801,532068228664,14136774587,14985525881.0,-848751294.0,6390027018,1005192029,100488448,63302255.0,37186193.0,538458255682,525678201646,151635430603.0,163802554.0,
20180802,531174597926,14845841305,15739472043.0,-893630738.0,6029617951,979244277,83721012,109668764.0,-25947752.0,537204215877,525144979975,172463748373.0,246092293.0,
20180803,528810410344,10333969639,12698157221.0,-2364187582.0,5914439526,979960703,81369704,80653278.0,716426.0,534724849870,522895970818,129015507834.0,146014700.0,
20180806,527221789894,11333112080,12921732530.0,-1588620450.0,5923876449,984292383,87366585,83034905.0,4331680.0,533145666343,521297913445,133072267190.0,145107681.0,
20180807,526392695026,13647402301,14476497169.0,-829094868.0,6336605165,1032783849,124365541,75874075.0,48491466.0,532729300191,520056089861,147683566754.0,155757740.0,
20180808,524900753790,12148588753,13640529989.0,-1491941236.0,6241793362,1041480966,95724617,87027500.0,8697117.0,531142547152,518658960428,140269910261.0,224258885.0,
20180809,524594839263,14142305620,14448220147.0,-305914527.0,6338098485,1017778368,90919810,114622408.0,-23702598.0,530932937748,518256740778,151095466538.0,153559967.0,
20180810,522761979654,10717952130,12550811739.0,-1832859609.0,6135874304,986127819,49297801,80948350.0,-31650549.0,528897853958,516626105350,123341425288.0,108650759.0,
20180813,523722819418,12671000229,11710160465.0,960839764.0,6164675703,986627009,72899310,72400120.0,499190.0,529887495121,517558143715,129695706280.0,115153751.0,
20180814,523860576227,10256594514,10118837705.0,137756809.0,6203418052,997632903,69657655,58651761.0,11005894.0,530063994279,517657158175,112568663972.0,128599557.0,
20180815,523990050346,11141066644,11011592525.0,129474119.0,6247687582,1036372243,95509976,56770636.0,38739340.0,530237737928,517742362764,118713279067.0,185154424.0,
20180816,524345738232,11552028924,11196341038.0,355687886.0,6203281111,1032619516,83446586,87199313.0,-3752727.0,530549019343,518142457121,117680566938.0,156662968.0,
20180817,522737305344,10584388929,12192821817.0,-1608432888.0,6015570649,1014558196,71621983,89683303.0,-18061320.0,528752875993,516721734695,115729078722.0,145475923.0,
20180820,521423369451,10005551727,11319487620.0,-1313935893.0,6208372544,1035044381,80791652,60305467.0,20486185.0,527631741995,515214996907,114844859155.0,148411625.0,
20180821,520047585196,11255287603,12631071858.0,-1375784255.0,6419033360,1062396663,89835700,62483418.0,27352282.0,526466618556,513628551836,122655681684.0,122342735.0,
20180822,519198247652,8808470525,9657808069.0,-849337544.0,6316111281,1043049813,56607463,75954313.0,-19346850.0,525514358933,512882136371,98471052348.0,74092239.0,
20180823,519453159802,10581583524,10326671374.0,254912150.0,6383123967,1048043683,70671234,65677364.0,4993870.0,525836283769,513070035835,107946949107.0,89386909.0,
20180824,517564307970,9256500111,11145351943.0,-1888851832.0,6378304598,1055434513,75249287,67858457.0,7390830.0,523942612568,511186003372,102860489353.0,57567770.0,
20180827,517733060699,14074148451,13905395722.0,168752729.0,6523414365,1054301900,76750583,77883196.0,-1132613.0,524256475064,511209646334,141557226922.0,130125662.0,
20180828,517411048779,11740251929,12062263849.0,-322011920.0,6441768720,1042957607,59946345,71290638.0,-11344293.0,523852817499,510969280059,125213868677.0,81490681.0,
20180829,516904203797,9502132118,10008977100.0,-506844982.0,6431264111,1040329134,54132688,56761161.0,-2628473.0,523335467908,510472939686,101314964778.0,113058429.0,
20180830,516491992705,9908792121,10321003213.0,-412211092.0,6351537378,1046450904,55828287,49706517.0,6121770.0,522843530083,510140455327,106374245492.0,103985359.0,
20180831,513956376664,9304499170,11840115211.0,-2535616041.0,6267288303,1041817390,65117617,69751131.0,-4633514.0,520223664967,507689088361,115064473019.0,129729762.0,
20180903,513290990055,9043222146,9708608755.0,-665386609.0,6395865599,1060669960,58590497,39737927.0,18852570.0,519686855654,506895124456,104797372938.0,87079317.0,
20180904,513182458484,11223222793,11331754364.0,-108531571.0,6537663165,1068453907,62339495,54555548.0,7783947.0,519720121649,506644795319,114067191976.0,107746320.0,
20180905,513010193653,10053210464,10225475295.0,-172264831.0,6412329432,1085991423,71523337,53985821.0,17537516.0,519422523085,506597864221,107630121012.0,80646223.0,
20180906,513256982251,9608460313,9361671715.0,246788598.0,6381320737,1078807739,71344598,78528282.0,-7183684.0,519638302988,506875661514,106316571295.0,87850586.0,
20180907,511137883134,9921058468,12040157585.0,-2119099117.0,6369394369,1062173109,67828582,84463212.0,-16634630.0,517507277503,504768488765,114021637118.0,89300394.0,
20180910,509479248423,8875075988,10533710699.0,-1658634711.0,6281188399,1071833210,71392454,61732353.0,9660101.0,515760436822,503198060024,102891544400.0,125317053.0,
20180911,508866481182,8123435533,8736202774.0,-612767241.0,6189182779,1046904337,66991260,91920133.0,-24928873.0,515055663961,502677298403,97325524010.0,130818849.0,
20180912,508765532668,8002677463,8103625977.0,-100948514.0,6078028399,1033696345,53396585,66604577.0,-13207992.0,514843561067,502687504269,93534880638.0,90824428.0,
20180913,508467827596,10491937857,10789642929.0,-297705072.0,6142824037,1042908465,79973742,70761622.0,9212120.0,514610651633,502325003559,112551718469.0,102429466.0,
20180914,506009498734,8382618687,10840947549.0,-2458328862.0,6177933709,1056096083,79063831,65876213.0,13187618.0,512187432443,499831565025,104980414145.0,70248645.0,
20180917,504993237974,7289053681,8305314441.0,-1016260760.0,6134288971,1067253779,63432849,52275153.0,11157696.0,511127526945,498858949003,87307615710.0,63312448.0,
20180918,504631339773,11111861194,11473759395.0,-361898201.0,6504278160,1120709601,128132152,74676330.0,53455822.0,511135617933,498127061613,113315100230.0,114423707.0,
20180919,502678815221,12564942247,14517466799.0,-1952524552.0,6653614608,1136684605,114817339,98842335.0,15975004.0,509332429829,496025200613,143412280983.0,141471662.0,
20180920,501271444915,9394648535,10802018841.0,-1407370306.0,6578365657,1114851206,53490103,75323502.0,-21833399.0,507849810572,494693079258,105071148233.0,83832322.0,
20180921,498777152833,14696528658,17190820740.0,-2494292082.0,6719384774,1119878493,93752742,88725455.0,5027287.0,505496537607,492057768059,149113774236.0,155956315.0,
20180925,499653250243,12021682276,11145584866.0,876097410.0,6508750346,1100679121,64425761,83625133.0,-19199372.0,506162000589,493144499897,108924598378.0,94202937.0,
20180926,499093628658,14668100299,15227721884.0,-559621585.0,6803855948,1143858629,116614737,73435229.0,43179508.0,505897484606,492289772710,145329431663.0,171128296.0,
20180927,497647547449,11426969305,12873050514.0,-1446081209.0,6625016713,1127435606,65247485,81670508.0,-16423023.0,504272564162,491022530736,123556618896.0,129529222.0,
20180928,492989890192,11449499099,16107156356.0,-4657657257.0,6579183795,1101661217,58705161,84479550.0,-25774389.0,499569073987,486410706397,125480056164.0,182790543.0,
20181008,496333847498,16604993961,13261036655.0,3343957306.0,6373994495,1097207895,69433659,73886981.0,-4453322.0,502707841993,489959853003,141636721530.0,230943364.0,
20181009,496798379422,10432337592,9967805668.0,464531924.0,6530696251,1119629924,75195563,52773534.0,22422029.0,503329075673,490267683171,110358748870.0,124437421.0,
20181010,496692130111,10218445695,10324695006.0,-106249311.0,6500221990,1126496935,70941838,64074827.0,6867011.0,503192352101,490191908121,111573354234.0,181726609.0,
20181011,489362003478,15297236005,22627362638.0,-7330126633.0,6030483129,1128217682,104965230,103244483.0,1720747.0,495392486607,483331520349,169736901996.0,372649481.0,
20181012,482668130673,11922965049,18616837854.0,-6693872805.0,6079655317,1133265783,108646344,103598243.0,5048101.0,488747785990,476588475356,142850575018.0,226174081.0,
20181015,479708528447,9157493390,12117095616.0,-2959602226.0,6092805129,1163912245,91507386,60860924.0,30646462.0,485801333576,473615723318,105286287102.0,108609636.0,
20181016,475305265051,9694959177,14098222573.0,-4403263396.0,6065648758,1169119221,98620186,93413210.0,5206976.0,481370913809,469239616293,107081053265.0,186486154.0,
20181017,472763724975,10739959108,13281499184.0,-2541540076.0,6137710907,1169827708,95738444,95029957.0,708487.0,478901435882,466626014068,117414772462.0,147339960.0,
20181018,470159311394,8745084559,11349498140.0,-2604413581.0,6043042341,1185207610,89550148,74170246.0,15379902.0,476202353735,464116269053,106554396432.0,149195401.0,
20181019,466894473017,11285156917,14549995294.0,-3264838377.0,6232229493,1195996714,109652823,98863719.0,10789104.0,473126702510,460662243524,130331038346.0,184875670.0,
20181022,467650052315,20309061131,19553481833.0,755579298.0,6791075394,1243599189,156385311,108782836.0,47602475.0,474441127709,460858976921,197379647523.0,311013899.0,
20181023,468538487733,16983554594,16095119176.0,888435418.0,6631903685,1217649813,115056142,141005518.0,-25949376.0,475170391418,461906584048,167079024649.0,178998554.0,
20181024,468452250683,14172966361,14259203411.0,-86237050.0,6860620570,1265720892,144239474,96168395.0,48071079.0,475312871253,461591630113,142181924250.0,134364816.0,
20181025,468119435880,13668498858,14001313661.0,-332814803.0,6836314483,1260912387,111500191,116308696.0,-4808505.0,474955750363,461283121397,137709069091.0,159965884.0,
20181026,467169473732,12558394091,13508356239.0,-949962148.0,6664265205,1244214719,86679903,103377571.0,-16697668.0,473833738937,460505208527,133465685247.0,94970685.0,
20181029,467955868930,12025543449,11239148251.0,786395198.0,6531241081,1230224918,85497954,99487755.0,-13989801.0,474487110011,461424627849,122651706443.0,74348216.0,
20181030,466687049647,14558310220,15827129503.0,-1268819283.0,6837184270,1277613102,139169130,91780946.0,47388184.0,473524233917,459849865377,152855694487.0,106452691.0,
20181031,466160156064,14153148211,14680041794.0,-526893583.0,6996687698,1281834514,116379112,112157700.0,4221412.0,473156843762,459163468366,154928249530.0,145441178.0,
20181101,465870071113,17137760322,17427845273.0,-290084951.0,7110507259,1286620052,117357218,112571680.0,4785538.0,472980578372,458759563854,181018196469.0,125854264.0,
20181102,464828736776,19849091432,20890425769.0,-1041334337.0,7219800758,1282758417,117875872,121737507.0,-3861635.0,472048537534,457608936018,208116174099.0,193233711.0,
20181105,466115042931,17349425406,16063119251.0,1286306155.0,7133329443,1272137473,94767119,105388063.0,-10620944.0,473248372374,458981713488,169324467364.0,167786534.0,
20181106,466581343674,12923212376,12456911633.0,466300743.0,7093425549,1268341140,102326506,106122839.0,-3796333.0,473674769223,459487918125,138949578059.0,204112586.0,
20181107,466902793065,14621002708,14299553317.0,321449391.0,7021329203,1266860357,103129340,104610123.0,-1480783.0,473924122268,459881463862,147684505667.0,123220429.0,
20181108,466765910615,12385496362,12522378812.0,-136882450.0,7064055157,1279949635,112574016,99484738.0,13089278.0,473829965772,459701855458,128757767463.0,123334770.0,
20181109,467006411052,11625464457,11384964020.0,240500437.0,6821653091,1247177983,72131065,104902717.0,-32771652.0,473828064143,460184757961,121343900498.0,138451591.0,
20181112,468798812385,14356508015,12564106682.0,1792401333.0,7085752463,1277396554,104013068,73794497.0,30218571.0,475884564848,461713059922,143084308579.0,132002104.0,
20181113,469651112918,20293806356,19441505823.0,852300533.0,7266641493,1273148543,117261606,121509617.0,-4248011.0,476917754411,462384471425,189810050743.0,204161642.0,
20181114,471116952401,18183832857,16717993374.0,1465839483.0,7124584991,1273677370,106882673,106353846.0,528827.0,478241537392,463992367410,176936974243.0,205957332.0,
20181115,472299226346,17736388343,16554114398.0,1182273945.0,7306742853,1269815834,114308897,118170433.0,-3861536.0,479605969199,464992483493,172060818165.0,261228723.0,
20181116,471864498649,21651038537,22085766234.0,-434727697.0,7106374624,1217168780,82199523,134846577.0,-52647054.0,478970873273,464758124025,204670667800.0,432300273.0,
20181119,473853869819,22508046500,20518675330.0,1989371170.0,7184138720,1228421574,95842193,84589399.0,11252794.0,481038008539,466669731099,196457358117.0,275791862.0,
20181120,475056211230,19727286603,18524945192.0,1202341411.0,6950610858,1233373349,98962184,94010409.0,4951775.0,482006822088,468105600372,181168108991.0,228146385.0,
20181121,475233531812,15593288878,15415968296.0,177320582.0,6935754162,1217818709,95112993,110667633.0,-15554640.0,482169285974,468297777650,151323007156.0,173605100.0,
20181122,475446195531,13029992143,12817328424.0,212663719.0,7127088124,1274394701,130992636,74416644.0,56575992.0,482573283655,468319107407,125718969273.0,110089068.0,
20181123,472689959467,13603404960,16359641024.0,-2756236064.0,6617169688,1210229320,67836185,132001566.0,-64165381.0,479307129155,466072789779,149943818848.0,230546938.0,
20181126,472356414911,10603880737,10937425293.0,-333544556.0,6857826040,1264099730,118938280,65067870.0,53870410.0,479214240951,465498588871,108605686874.0,123961789.0,
20181127,472518416397,10311147295,10149145809.0,162001486.0,6921498998,1258106746,79656181,85649165.0,-5992984.0,479439915395,465596917399,102344303147.0,114564346.0,
20181128,471762479372,12021271672,12777208697.0,-755937025.0,6923062423,1247923056,83969136,94152826.0,-10183690.0,478685541795,464839416949,119537802094.0,124649346.0,
20181129,470522757696,12564996083,13804717759.0,-1239721676.0,6830567716,1250901857,91752563,88773762.0,2978801.0,477353325412,463692189980,129527629983.0,125157604.0,
20181130,468743399761,9849274010,11628631945.0,-1779357935.0,6859536436,1250397028,87240526,87745355.0,-504829.0,475602936197,461883863325,112819375524.0,349811044.0,
20181203,469245598003,19418344647,18916146405.0,502198242.0,7229588572,1283051737,107693093,75038384.0,32654709.0,476475186575,462016009431,187735939585.0,237786247.0,
20181204,469135276155,14808620158,14918942006.0,-110321848.0,7242872772,1276013784,87965523,95003476.0,-7037953.0,476378148927,461892403383,144243795851.0,132329973.0,
20181205,469009226480,13499366103,13625415778.0,-126049675.0,7160856135,1263649962,92081478,104445300.0,-12363822.0,476170082615,461848370345,134103821664.0,159580935.0,
20181206,470166691402,13740797451,12583332529.0,1157464922.0,6875567625,1253819112,95360789,105191639.0,-9830850.0,477042259027,463291123777,129369314964.0,122415418.0,
20181207,469305526326,9143076755,10004241831.0,-861165076.0,6759226739,1224191048,57060322,86688386.0,-29628064.0,476064753065,462546299587,97855605312.0,68201581.0,
20181210,469640781271,9392252034,9056997089.0,335254945.0,6695463184,1242843037,85699396,67047407.0,18651989.0,476336244455,462945318087,99154316921.0,89025408.0,
20181211,469293601471,8066600259,8413780059.0,-347179800.0,6605861080,1205497431,60569806,97915412.0,-37345606.0,475899462551,462687740391,86327570736.0,69433117.0,
20181212,469095178379,8481922578,8680345670.0,-198423092.0,6694523570,1220605365,66607188,51499254.0,15107934.0,475789701949,462400654809,89233719931.0,91331003.0,
20181213,469359024408,13842831461,13578985432.0,263846029.0,6963324308,1250503052,111139010,81241323.0,29897687.0,476322348716,462395700100,133133638786.0,128916549.0,
20181214,467350549615,11184369207,13192844000.0,-2008474793.0,6547021947,1206872259,72131272,115762065.0,-43630793.0,473897571562,460803527668,124054580035.0,81329107.0,
20181217,467686247128,10124632791,9788935278.0,335697513.0,6525530228,1208953478,71970641,69889422.0,2081219.0,474211777356,461160716900,103530021632.0,69723322.0,
20181218,467607913280,9500577283,9578911131.0,-78333848.0,6372120420,1190228294,80386476,99111660.0,-18725184.0,473980033700,461235792860,99826113834.0,73566828.0,
20181219,466785517266,8303447450,9125843464.0,-822396014.0,6137428055,1153880970,55914775,92262099.0,-36347324.0,472922945321,460648089211,93890721864.0,57270278.0,
20181220,467700056854,10660245549,9745705961.0,914539588.0,6036356598,1135546063,81714578,100049485.0,-18334907.0,473736413452,461663700256,103735561361.0,90746880.0,
20181221,466520920169,8910954619,10090091304.0,-1179136685.0,5785523079,1095555834,56456627,96446856.0,-39990229.0,472306443248,460735397090,102207639079.0,127099114.0,
20181224,466694612238,8058286210,7884594141.0,173692069.0,5942677972,1129879688,94574734,60250880.0,34323854.0,472637290210,460751934266,86129815607.0,81029033.0,
20181225,465977437816,11198667482,11915841904.0,-717174422.0,5928863416,1140607373,119637128,108909443.0,10727685.0,471906301232,460048574400,114892074887.0,125714662.0,
20181226,465856293975,9000312721,9121456562.0,-121143841.0,5920976211,1141877019,84598375,83328729.0,1269646.0,471777270186,459935317764,97291946791.0,91168229.0,
20181227,465434791784,10297963054,10719465245.0,-421502191.0,6010134313,1167340231,83213099,57749887.0,25463212.0,471444926097,459424657471,114961616157.0,81735675.0,
20181228,461987376518,8230524637,11677939903.0,-3447415266.0,5807127861,1122525820,64719099,109533510.0,-44814411.0,467794504379,456180248657,110763483662.0,82186769.0,
20190102,462351753650,9073727044,8709349912.0,364377132.0,5714014114,1098468832,59090736,83147724.0,-24056988.0,468065767764,456637739536,97835302795.0,83518563.0,
20190103,461887281000,9187520553,9651993203.0,-464472650.0,5854923494,1122021818,79531121,55978135.0,23552986.0,467742204494,456032357506,108231265123.0,148418478.0,
20190104,462250410730,13853868136,13490738406.0,363129730.0,6000748759,1120988370,86298981,87332429.0,-1033448.0,468251159489,456249661971,139641321687.0,156533363.0,
20190107,462458355219,14233893206,14025948717.0,207944489.0,6202011515,1146589074,85494668,59893964.0,25600704.0,468660366734,456256343704,145375466245.0,171725171.0,
20190108,462472442828,11671232442,11657144833.0,14087609.0,6248209523,1158266222,82313082,70635934.0,11677148.0,468720652351,456224233305,123436615233.0,124265999.0,
20190109,461689424168,15835508236,16618526896.0,-783018660.0,6378866662,1182093297,119948522,96121447.0,23827075.0,468068290830,455310557506,160897092937.0,176470037.0,
20190110,461532461893,12334029026,12490991301.0,-156962275.0,6192451286,1135095637,62726774,109724434.0,-46997660.0,467724913179,455340010607,132658345974.0,118430224.0,
20190111,460323775055,10693099107,11901785945.0,-1208686838.0,6193426510,1135891303,74373837,73578171.0,795666.0,466517201565,454130348545,122406772493.0,105938033.0,
20190114,460947518023,10515099617,9891356649.0,623742968.0,6152103839,1136296781,68758482,68353004.0,405478.0,467099621862,454795414184,116221548467.0,71526898.0,
20190115,460338181685,13309807755,13919144093.0,-609336338.0,6283407281,1130232218,103821564,109886127.0,-6064563.0,466621588966,454054774404,137746981210.0,132117034.0,
20190116,459037993700,11569730459,12869918444.0,-1300187985.0,6206006131,1125879640,73966702,78319280.0,-4352578.0,465243999831,452831987569,127101055440.0,100967292.0,
20190117,458623130349,12779748834,13194612185.0,-414863351.0,6214380734,1136406351,84602763,74076052.0,10526711.0,464837511083,452408749615,127539143382.0,117942247.0,
20190118,456668089943,14120002196,16075042602.0,-1955040406.0,6158543944,1104573323,89668703,121501731.0,-31833028.0,462826633887,450509545999,151369988175.0,131166631.0,
20190121,456096234282,13498362054,14070217715.0,-571855661.0,6168221783,1098121269,74371675,80823729.0,-6452054.0,462264456065,449928012499,140008351396.0,89425253.0,
20190122,457169620037,12374675830,11301290075.0,1073385755.0,5848841730,1057968944,65296518,105448843.0,-40152325.0,463018461767,451320778307,123021874858.0,93408444.0,
20190123,456649149578,9593360205,10113830664.0,-520470459.0,5832369934,1052008371,56171399,62131972.0,-5960573.0,462481519512,450816779644,105324252913.0,74719535.0,
20190124,455891899209,11851467748,12608718117.0,-757250369.0,5946914033,1051420369,67123886,67711888.0,-588002.0,461838813242,449944985176,131536837814.0,152049848.0,
20190125,452458688565,11015660718,14448871362.0,-3433210644.0,5889191154,1048273318,67776226,70923277.0,-3147051.0,458347879719,446569497411,135419327369.0,107446357.0,
20190128,451157215423,11655037680,12956510822.0,-1301473142.0,5829807368,1038172701,64843482,74944099.0,-10100617.0,456987022791,445327408055,127401316208.0,82827382.0,
20190129,449290368941,10847545001,12714391483.0,-1866846482.0,5698281406,1019826473,75864009,94210237.0,-18346228.0,454988650347,443592087535,126758653164.0,107047501.0,
20190130,447513860371,8176777752,9953286322.0,-1776508570.0,5401332274,964352754,39910790,95384509.0,-55473719.0,452915192645,442112528097,101053282693.0,81297332.0,
20190131,444603342646,10652745126,13563262851.0,-2910517725.0,5291350496,942170266,58254087,80436575.0,-22182488.0,449894693142,439311992150,126182972884.0,139102409.0,
20190201,438481618486,9167907563,15289631723.0,-6121724160.0,5144864769,900773251,31657502,73054517.0,-41397015.0,443626483255,433336753717,111424636469.0,110150919.0,
20190211,441723272260,15233912673,11992258899.0,3241653774.0,5560296496,961380232,84886710,24279729.0,60606981.0,447283568756,436162975764,141092800828.0,154761858.0,
20190212,443198997474,16272580034,14796854820.0,1475725214.0,5745346454,989411843,102740624,74709013.0,28031611.0,448944343928,437453651020,181449981372.0,149007472.0,
20190213,445877866753,23431620671,20752751392.0,2678869279.0,6129272703,1034361568,128903463,83953738.0,44949725.0,452007139456,439748594050,207027589482.0,247973657.0,
20190214,447472501005,18337413351,16742779099.0,1594634252.0,6088145915,1023600324,72213938,82975182.0,-10761244.0,453560646920,441384355090,170166265779.0,196200571.0,
20190215,449451785567,18711205768,16731921206.0,1979284562.0,5736632641,989257449,62770838,97113713.0,-34342875.0,455188418208,443715152926,170297376385.0,153832428.0,
20190218,451906400957,25117598055,22662982665.0,2454615390.0,6391062117,1049513154,131952212,71696507.0,60255705.0,458297463074,445515338840,225713308787.0,246457543.0,
20190219,455192743990,28625386942,25339043909.0,3286343033.0,6260721866,1023843169,95927415,121597400.0,-25669985.0,461453465856,448932022124,247077877918.0,240779753.0,
20190220,457184818881,23002027138,21009952247.0,1992074891.0,6310806597,1046478607,111531397,88895959.0,22635438.0,463495625478,450874012284,205988671302.0,152603078.0,
20190221,459234809159,29335136538,27285146260.0,2049990278.0,6528489311,1069181895,133286029,110582741.0,22703288.0,465763298470,452706319848,254794068245.0,284236046.0,
20190222,461954859629,32419548758,29699498288.0,2720050470.0,6633130375,1048598706,114939138,135522327.0,-20583189.0,468587990004,455321729254,264515389443.0,284652370.0,
20190225,472704160094,60257058289,49507757824.0,10749300465.0,7439612565,1122819511,200638905,126418100.0,74220805.0,480143772659,465264547529,467683137255.0,699991915.0,
20190226,478155076613,61778381795,56327465276.0,5450916519.0,7165801337,1081794097,133725527,174750941.0,-41025414.0,485320877950,470989275276,492155758325.0,632578295.0,
20190227,484549266902,51742607833,45348417544.0,6394190289.0,7058566556,1072246554,139523339,149070882.0,-9547543.0,491607833458,477490700346,412464384736.0,432239528.0,
20190228,484555495642,34284100277,34277871537.0,6228740.0,6802372203,1038693321,101264475,134817708.0,-33553233.0,491357867845,477753123439,298668629534.0,322765284.0,
20190301,484550188993,36818605234,36823911883.0,-5306649.0,6972755094,1042939744,133443657,129197234.0,4246423.0,491522944087,477577433899,308154091344.0,262809528.0,
20190304,491719613594,61979499206,54810074605.0,7169424601.0,7567714697,1126548442,204847024,121238326.0,83608698.0,499287328291,484151898897,480463784339.0,543895923.0,
20190305,499610506952,50007817140,42116923782.0,7890893358.0,7526294846,1115309507,144120423,155359358.0,-11238935.0,507136801798,492084212106,383264130697.0,441537172.0,
20190306,509414858080,65730782793,55926431665.0,9804351128.0,7873221114,1152119892,204309161,167498776.0,36810385.0,517288079194,501541636966,486699006008.0,473041429.0,
20190307,519397678384,71739590059,61756769755.0,9982820304.0,7681681754,1106234957,168824246,214709181.0,-45884935.0,527079360138,511715996630,525586052226.0,516699401.0,
20190308,519973258458,60296306570,59720726496.0,575580074.0,6952524243,1030756129,135365618,210844446.0,-75478828.0,526925782701,513020734215,525384836655.0,495393886.0,
20190311,528539041036,51014326360,42448543782.0,8565782578.0,7081333275,1039732965,187655596,178678760.0,8976836.0,535620374311,521457707761,404809192656.0,311000569.0,
20190312,534177143108,62158744961,56520642889.0,5638102072.0,7378951309,1074156481,195309393,160885877.0,34423516.0,541556094417,526798191799,487439327097.0,407674966.0,
20190313,537118191110,55850100494,52909052492.0,2941048002.0,7150452732,1069952552,175762015,179965944.0,-4203929.0,544268643842,529967738378,451061554147.0,462451421.0,
20190314,535868334393,40374818674,41624675391.0,-1249856717.0,6809600412,1022162056,135403005,183193501.0,-47790496.0,542677934805,529058733981,356536525144.0,351202602.0,
20190315,534927567528,41487210170,42427977035.0,-940766865.0,6935786537,1028114404,150483804,144531456.0,5952348.0,541863354065,527991780991,346458105748.0,420856340.0,
20190318,538936145587,49192353470,45183775411.0,4008578059.0,7490082590,1082601950,187111696,132624150.0,54487546.0,546426228177,531446062997,398737214373.0,314234155.0,
20190319,542161873286,43941414651,40715686952.0,3225727699.0,7368346110,1074513188,132076009,140164771.0,-8088762.0,549530219396,534793527176,353152174934.0,185068239.0,
20190320,544227583847,44045275616,41979565055.0,2065710561.0,7565770022,1095769302,170697567,149441453.0,21256114.0,551793353869,536661813825,349367093130.0,202686949.0,
20190321,549423715029,53670381879,48474250697.0,5196131182.0,7635981051,1097401915,164607739,162975126.0,1632613.0,557059696080,541787733978,404153863776.0,295082556.0,
20190322,549160945947,44500433858,44763202940.0,-262769082.0,7491446372,1081840699,145828715,161389931.0,-15561216.0,556652392319,541669499575,356850407885.0,285856407.0,
20190325,554217910683,48629467519,43572502783.0,5056964736.0,7330480585,1078683267,155011853,158169285.0,-3157432.0,561548391268,546887430098,375423173079.0,267870129.0,
20190326,554043266609,40209100807,40383744881.0,-174644074.0,6844617743,1012826904,131856288,197712651.0,-65856363.0,560887884352,547198648866,341545270368.0,243463833.0,
20190327,555908994882,34574191606,32708463333.0,1865728273.0,6988136999,1028108624,151229050,135947330.0,15281720.0,562897131881,548920857883,295302547439.0,149139736.0,
20190328,555438962621,34646709708,35116741969.0,-470032261.0,6993676803,1037645116,152641236,143104744.0,9536492.0,562432639424,548445285818,289606869873.0,130505580.0,
20190329,555919750875,47821612832,47340824578.0,480788254.0,7371057196,1039055432,219567226,218156910.0,1410316.0,563290808071,548548693679,386531362071.0,257164390.0,
20190401,561244963862,63290251721,57965038734.0,5325212987.0,8010959023,1108578403,219114881,149591910.0,69522971.0,569255922885,553234004839,480404718346.0,574281519.0,
20190402,566121855650,61545143289,56668251501.0,4876891788.0,7705881744,1060360344,150022768,198240827.0,-48218059.0,573827737394,558415973906,462364839936.0,365298814.0,
20190403,569552117271,58245986188,54815724567.0,3430261621.0,7994854942,1085896199,191522831,165986976.0,25535855.0,577546972213,561557262329,442515458290.0,457791069.0,
20190404,570001321985,62428623909,61979419195.0,449204714.0,7896289622,1066403269,156663359,176156289.0,-19492930.0,577897611607,562105032363,475154928034.0,504744108.0,
20190408,579824640228,71019531166,61196212923.0,9823318243.0,8077000019,1126245742,214981056,155138583.0,59842473.0,587901640247,571747640209,506074257133.0,457096600.0,
20190409,582591393394,49975237698,47208484532.0,2766753166.0,7893889401,1082387455,164489669,208347956.0,-43858287.0,590485282795,574697503993,380298969551.0,245936349.0,
20190410,584052810698,51270632794,49809215490.0,1461417304.0,7976475409,1101505220,183961543,164843778.0,19117765.0,592029286107,576076335289,395663827936.0,293355760.0,
20190411,583208143243,43791954590,44636622045.0,-844667455.0,7516621319,1049665764,128656884,180496340.0,-51839456.0,590724764562,575691521924,361151323695.0,253766257.0,
20190412,581164513945,33700743868,35744373166.0,-2043629298.0,7298662903,1022500698,141754049,168919115.0,-27165066.0,588463176848,573865851042,289268703782.0,180736540.0,
20190415,583299208979,44636372612,42501677578.0,2134695034.0,7643113739,1090692110,212024206,143832794.0,68191412.0,590942322718,575656095240,355699785726.0,213125283.0,
20190416,587420822124,46426809950,42305196805.0,4121613145.0,7841722599,1090319316,212919418,213292212.0,-372794.0,595262544723,579579099525,360207901029.0,215719918.0,
20190417,589911050836,43694908636,41204679924.0,2490228712.0,7774800992,1086266189,145639001,149692128.0,-4053127.0,597685851828,582136249844,354496460306.0,159968194.0,
20190418,591175252232,41409359321,40145157925.0,1264201396.0,7760487190,1088724076,121886392,119428505.0,2457887.0,598935739422,583414765042,323763311969.0,224637577.0,
20190419,591196274296,42365440576,42344418512.0,21022064.0,7821050157,1082800723,139821138,145744491.0,-5923353.0,599017324453,583375224139,315514872393.0,173525876.0,
20190422,594831558594,48086084184,44450799886.0,3635284298.0,7712007391,1092875237,155567650,145493136.0,10074514.0,602543565985,587119551203,359553983464.0,236641036.0,
20190423,593401459965,36853749447,38283848076.0,-1430098629.0,7654827292,1093288720,157274131,156860648.0,413483.0,601056287257,585746632673,324973241865.0,186001363.0,
20190424,595388886472,34168495627,32181069120.0,1987426507.0,7468238475,1066587240,121951414,148652894.0,-26701480.0,602857124947,587920647997,279106135789.0,168463995.0,
20190425,591947751543,33493414729,36934549658.0,-3441134929.0,7179957493,1047143113,140383428,159827555.0,-19444127.0,599127709036,584767794050,309020754008.0,236023247.0,
20190426,589923831402,29060795668,31084715809.0,-2023920141.0,6546971604,935585438,106008294,217565969.0,-111557675.0,596470803006,583376859798,275204059631.0,174509591.0,
20190429,585302832156,26035623014,30656622260.0,-4620999246.0,6637515223,961419760,158269812,132435490.0,25834322.0,591940347379,578665316933,289368312743.0,251764479.0,
20190430,577865182474,21312609774,28750259456.0,-7437649682.0,5966965402,848859248,77741753,190302265.0,-112560512.0,583832147876,571898217072,225913992988.0,132714455.0,
20190506,573185674230,32207427307,36886935551.0,-4679508244.0,5703020317,856577217,194509051,186791082.0,7717969.0,578888694547,567482653913,314126451526.0,438166167.0,
20190507,570866704572,23222772103,25541741761.0,-2318969658.0,5755159556,849974346,163480079,170082950.0,-6602871.0,576621864128,565111545016,245424372479.0,166420510.0,
20190508,571057518334,21222830163,21032016401.0,190813762.0,5667420255,855384607,159184127,153773866.0,5410261.0,576724938589,565390098079,218777243976.0,185870433.0,
20190509,570455002203,18741470576,19343986707.0,-602516131.0,5358468045,816305544,124007307,163086370.0,-39079063.0,575813470248,565096534158,197653741932.0,123650639.0,
20190510,569552302327,30290064958,31192764834.0,-902699876.0,6046023197,889334532,220537499,147508511.0,73028988.0,575598325524,563506279130,274221225908.0,188395009.0,
20190513,567689658746,20305925919,22168569500.0,-1862643581.0,5682066267,857051228,130740783,163024087.0,-32283304.0,573371725013,562007592479,203190335270.0,111617241.0,
20190514,566964503072,18778651271,19503806945.0,-725155674.0,5765841597,878326362,148113962,126838828.0,21275134.0,572730344669,561198661475,201705692164.0,110148367.0,
20190515,566600704440,24966930292,25330728924.0,-363798632.0,6144535731,921570194,176197075,132953243.0,43243832.0,572745240171,560456168709,226545666483.0,120310094.0,
20190516,567049805145,24093237882,23644137177.0,449100705.0,6395954054,958825357,171757618,134502455.0,37255163.0,573445759199,560653851091,226417159676.0,114345471.0,
20190517,563665781997,23159994350,26544017498.0,-3384023148.0,5818970670,886002209,120129193,192952341.0,-72823148.0,569484752667,557846811327,247811496515.0,151529739.0,
20190520,563258751070,19776457362,20183488289.0,-407030927.0,5805947974,892524358,156738712,150216563.0,6522149.0,569064699044,557452803096,201502837396.0,158215320.0,
20190521,563899124599,21242688734,20602315205.0,640373529.0,6100228979,935508281,179909198,136925275.0,42983923.0,569999353578,557798895620,202896236235.0,108925009.0,
20190522,562387964684,18996661933,20507821848.0,-1511159915.0,6091053275,933739619,138323736,140092398.0,-1768662.0,568479017959,556296911409,193748639180.0,65708142.0,
20190523,560527552182,19064612978,20925025480.0,-1860412502.0,6018286664,930593681,144633497,147779435.0,-3145938.0,566545838846,554509265518,192774552214.0,110098000.0,
20190524,557750049494,14975157319,17752660007.0,-2777502688.0,5794135953,884355253,109930151,156168579.0,-46238428.0,563544185447,551955913541,162821698478.0,111980943.0,
20190527,559792435668,21454269577,19411883403.0,2042386174.0,6148749960,925445031,171337468,130247690.0,41089778.0,565941185628,553643685708,194777596997.0,110037948.0,
20190528,558474984580,21929366388,23246817476.0,-1317451088.0,6271102872,950773602,152580994,127252423.0,25328571.0,564746087452,552203881708,227620051947.0,241969888.0,
20190529,558801967110,21451472742,21124490212.0,326982530.0,6358911393,956178757,128723984,123318829.0,5405155.0,565160878503,552443055717,203119666560.0,86973814.0,
20190530,557674222555,18748916524,19876661079.0,-1127744555.0,6253137384,955597546,125869094,126450305.0,-581211.0,563927359939,551421085171,197350651713.0,93924154.0,
20190531,555440566101,18170958432,20404614886.0,-2233656454.0,6234483391,961147010,126671619,121122155.0,5549464.0,561675049492,549206082710,191427472696.0,91739219.0,
20190603,554095723600,17940023324,19284865825.0,-1344842501.0,6231060446,958029201,111540759,114658568.0,-3117809.0,560326784046,547864663154,208465344361.0,114398237.0,
20190604,551845445249,15042718343,17292996694.0,-2250278351.0,5919666354,912723203,83076207,128382205.0,-45305998.0,557765111603,545925778895,181660381146.0,76697982.0,
20190605,550165203687,16165738275,17845979837.0,-1680241562.0,6173462807,942753721,112172863,82142345.0,30030518.0,556338666494,543991740880,176563984832.0,85533826.0,
20190606,546661467639,13792663864,17296399912.0,-3503736048.0,5755371448,897720602,87563151,132596270.0,-45033119.0,552416839087,540906096191,164840255965.0,77692222.0,
20190610,545807399551,15159958602,16014026690.0,-854068088.0,6179611385,981763208,162767345,78724739.0,84042606.0,551987010936,539627788166,163995039468.0,74104506.0,
20190611,546076092112,25901923830,25633231269.0,268692561.0,6708242864,1020279068,201308603,162792743.0,38515860.0,552784334976,539367849248,256127942719.0,201210864.0,
20190612,547092700496,23698474021,22681865637.0,1016608384.0,6421699821,988439381,111584322,143424009.0,-31839687.0,553514400317,540671000675,223160674651.0,100097858.0,
20190613,547506113249,19409203739,18995790986.0,413412753.0,6543232826,1005400217,123215412,106254576.0,16960836.0,554049346075,540962880423,192394401430.0,96484928.0,
20190614,545365849561,17408020785,19548284473.0,-2140263688.0,6284329054,971139534,83694657,117955340.0,-34260683.0,551650178615,539081520507,194424440375.0,132459485.0,
20190617,544906059569,12824537522,13284327514.0,-459789992.0,6511776511,993238362,112758057,90659229.0,22098828.0,551417836080,538394283058,143385487407.0,96378615.0,
20190618,543689979601,11716363393,12932443361.0,-1216079968.0,6524573678,977683089,79056895,94612168.0,-15555273.0,550214553279,537165405923,137664453811.0,75102541.0,
20190619,543194212320,23848713859,24344481140.0,-495767281.0,6881742813,1003074026,129845601,104454664.0,25390937.0,550075955133,536312469507,226325149359.0,125452072.0,
20190620,545474733422,31754452247,29473931145.0,2280521102.0,7404871184,1027993970,184789927,159869983.0,24919944.0,552879604606,538069862238,289037510080.0,156682627.0,
20190621,544809211659,28470399947,29135921710.0,-665521763.0,7193834165,994752927,124591015,157832058.0,-33241043.0,552003045824,537615377494,277075415845.0,255742309.0,
20190624,546922849389,22879628999,20765991269.0,2113637730.0,7198066420,1001018406,123305254,117039775.0,6265479.0,554120915809,539724782969,211289891508.0,155476861.0,
20190625,548267174410,26105690652,24761365631.0,1344325021.0,7139459583,981551948,133199467,152665925.0,-19466458.0,555406633993,541127714827,244739920741.0,176367006.0,
20190626,547799690532,16138911252,16606395130.0,-467483878.0,7067117009,1006264828,133504885,108792005.0,24712880.0,554866807541,540732573523,172883805071.0,111140865.0,
20190627,547617686319,20769366046,20951370259.0,-182004213.0,7464304394,1027275946,140430572,119419454.0,21011118.0,555081990713,540153381925,209510782312.0,121735662.0,
20190628,545403611820,18258359192,20472433691.0,-2214074499.0,7264107771,1030666659,129999733,126609020.0,3390713.0,552667719591,538139504049,183795332197.0,152650378.0,
20190701,548115136533,32105800133,29394275420.0,2711524713.0,7576365455,1028740679,132993596,134919576.0,-1925980.0,555691501988,540538771078,266890595659.0,211910421.0,
20190702,549329550799,22732924143,21518509877.0,1214414266.0,7651458132,1070295430,130462802,88908051.0,41554751.0,556981008931,541678092667,230683272500.0,144201728.0,
20190703,550488925077,22292827567,21133453289.0,1159374278.0,7532852077,1057887153,106703379,119111656.0,-12408277.0,558021777154,542956073000,220045401779.0,108084533.0,
20190704,550607512075,19205073061,19086486063.0,118586998.0,7626456053,1080378656,128917227,106425724.0,22491503.0,558233968128,542981056022,202537245420.0,109640363.0,
20190705,549758208389,15440449145,16289752831.0,-849303686.0,7472703152,1042673926,88688427,126393157.0,-37704730.0,557230911541,542285505237,163321786379.0,185747144.0,
20190708,549280291963,20109650621,20587567047.0,-477916426.0,7341049956,1058149163,132458406,116983169.0,15475237.0,556621341919,541939242007,205602265642.0,245102949.0,
20190709,548742383856,13913309898,14451218005.0,-537908107.0,7361346957,1066690610,104708251,96166804.0,8541447.0,556103730813,541381036899,154510526272.0,92273764.0,
20190710,548502478946,12920602089,13160506999.0,-239904910.0,7475127328,1090137163,92449347,69002794.0,23446553.0,555977606274,541027351618,141335762709.0,151836237.0,
20190711,546736009397,14226296727,15992766276.0,-1766469549.0,7643212116,1109233054,99253840,80157949.0,19095891.0,554379221513,539092797281,152357732814.0,103540105.0,
20190712,545292920109,12969227189,14412316477.0,-1443089288.0,7599876580,1096069461,94597817,107761410.0,-13163593.0,552892796689,537693043529,142899452146.0,124505611.0,
20190715,546829583252,18209150660,16672487517.0,1536663143.0,7795615787,1112046313,141967109,125990257.0,15976852.0,554625199039,539033967465,176628881890.0,95801475.0,
20190716,546419207751,12932999579,13343375080.0,-410375501.0,7406653782,1054555117,65030217,122521413.0,-57491196.0,553825861533,539012553969,141072762625.0,78799764.0,
20190717,546770795139,15127279382,14775691994.0,351587388.0,7489499813,1080888260,116911675,90578532.0,26333143.0,554260294952,539281295326,152335243550.0,53609007.0,
20190718,545891094423,13360574455,14240275171.0,-879700716.0,7356311165,1064147607,98255887,114996540.0,-16740653.0,553247405588,538534783258,149294823333.0,77883695.0,
20190719,544117046863,14190650518,15964698078.0,-1774047560.0,7363938242,1052285915,89660833,101522525.0,-11861692.0,551480985105,536753108621,149186293535.0,99861298.0,
20190722,542317389721,14395752888,16195410030.0,-1799657142.0,8069299105,1106159587,137249689,83376017.0,53873672.0,550386688826,534248090616,156352671347.0,80898542.0,48577601492.0
20190723,540885652598,11409695835,12841432958.0,-1431737123.0,8158033022,1098235097,80812728,88737218.0,-7924490.0,549043685620,532727619576,125967678493.0,55110355.0,22845015466.0
20190724,540838721429,15440730004,15487661173.0,-46931169.0,8637550851,1141817461,123257848,79675484.0,43582364.0,549476272280,532201170578,156293103999.0,85243369.0,22804584722.0
20190725,540617344435,15146953154,15368330148.0,-221376994.0,9006643170,1162817489,102442845,81442817.0,21000028.0,549623987605,531610701265,146335532411.0,133519798.0,29266764391.0
20190726,539752245878,13373392102,14238490659.0,-865098557.0,9032162431,1168169545,90970023,85617967.0,5352056.0,548784408309,530720083447,139517508340.0,77968568.0,19685723542.0
20190729,541103076216,13361287667,12010457329.0,1350830338.0,9244310333,1204297265,115389393,79261673.0,36127720.0,550347386549,531858765883,127812257896.0,61615044.0,20807665920.0
20190730,541192071940,16118821650,16029825926.0,88995724.0,9347245715,1168070497,84424563,120651331.0,-36226768.0,550539317655,531844826225,146509552550.0,87629092.0,24662313674.0
20190731,540746046599,14389532212,14835557553.0,-446025341.0,9467471922,1182610070,117909562,103369989.0,14539573.0,550213518521,531278574677,140394732760.0,177445593.0,24440663472.0
20190801,540682032669,14062984366,14126998296.0,-64013930.0,9337139934,1141559572,87049977,128100475.0,-41050498.0,550019172603,531344892735,142033450053.0,170205659.0,29180200857.0
20190802,538926998030,17383366860,19138401499.0,-1755034639.0,9369483734,1132426423,118873439,128006588.0,-9133149.0,548296481764,529557514296,173448994388.0,130946789.0,43045875537.0
20190805,539088661040,16607158292,16445495282.0,161663010.0,9582530513,1146632548,120673626,106467501.0,14206125.0,548671191553,529506130527,162689058277.0,227655670.0,34212825286.0
20190806,536449029000,20041599701,22681231741.0,-2639632040.0,9413801749,1149549985,153501028,150583591.0,2917437.0,545862830749,527035227251,212863781972.0,242019636.0,42493270332.0
20190807,534335401053,12558575199,14672203146.0,-2113627947.0,9675984001,1194277650,150927008,106199343.0,44727665.0,544011385054,524659417052,151234047099.0,125601768.0,25830563265.0
20190808,533481575844,13634118004,14487943213.0,-853825209.0,10314485611,1255018288,161742765,101002127.0,60740638.0,543796061455,523167090233,149569291048.0,122892446.0,28741760035.0
20190809,531240738575,13155759330,15396596599.0,-2240837269.0,10236133794,1250342572,108385987,113061703.0,-4675716.0,541476872369,521004604781,148552759860.0,95350063.0,22811357884.0
20190812,531567416332,13712223731,13385545974.0,326677757.0,10651297822,1275695226,126034467,100681813.0,25352654.0,542218714154,520916118510,141188608577.0,85646313.0,21547285081.0
20190813,531855170860,13638202516,13350447988.0,287754528.0,10727861522,1287855952,99611437,87450711.0,12160726.0,542583032382,521127309338,134566445446.0,87804433.0,19667812182.0
20190814,532093964720,15677295712,15438501852.0,238793860.0,10702727543,1268795072,89760929,108821809.0,-19060880.0,542796692263,521391237177,154370850448.0,98349869.0,20113880918.0
20190815,531287578318,14891693054,15698079456.0,-806386402.0,10700550002,1240529823,111183092,139448341.0,-28265249.0,541988128320,520587028316,155840463795.0,102600739.0,18024671068.0
20190816,530938203843,16881484324,17230858799.0,-349374475.0,10027664791,1196544697,87327235,131312361.0,-43985126.0,540965868634,520910539052,168949912755.0,110673914.0,17429900193.0
20190819,534798962347,26933254389,23072495885.0,3860758504.0,10686571813,1254363131,159242978,101424544.0,57818434.0,545485534160,524112390534,229494142679.0,137009328.0,17833634394.0
20190820,535069125138,20899546691,20629383900.0,270162791.0,10579203659,1247511110,114427771,121279792.0,-6852021.0,545648328797,524489921479,200320602378.0,123755363.0,13778748832.0
20190821,535653416579,17490915722,16906624281.0,584291441.0,10616857288,1250150460,101681380,99042030.0,2639350.0,546270273867,525036559291,166496125669.0,127704041.0,17237657764.0
20190822,536149988643,16082314254,15585742190.0,496572064.0,10655540918,1261844075,118751026,107057411.0,11693615.0,546805529561,525494447725,158703226882.0,92359579.0,11120722465.0
20190823,534954183704,18010394142,19206199081.0,-1195804939.0,10741650800,1271403756,108639041,99079360.0,9559681.0,545695834504,524212532904,179044390313.0,82428264.0,15136926447.0
20190826,536544973668,19098662590,17507872626.0,1590789964.0,10455657926,1235033574,74670660,111040842.0,-36370182.0,547000631594,526089315742,181589025910.0,114700251.0,9720384994.0
20190827,536284871635,22019856026,22279958059.0,-260102033.0,10806763690,1273757036,132884721,94161259.0,38723462.0,547091635325,525478107945,222039216262.0,165047379.0,9053504170.0
20190828,537103608725,19240666348,18421929258.0,818737090.0,10620620315,1262211505,103369133,114914664.0,-11545531.0,547724229040,526482988410,192525274925.0,110551375.0,9552528617.0
20190829,538787831176,19236034328,17551811877.0,1684222451.0,10746547843,1273930144,106985030,95266391.0,11718639.0,549534379019,528041283333,186443732576.0,94336720.0,10309554777.0
20190830,538541616594,22533030608,22779245190.0,-246214582.0,10896705119,1287987192,116966660,102909612.0,14057048.0,549438321713,527644911475,215571052809.0,79330084.0,9267153958.0
20190902,540259932065,23631868473,21913553002.0,1718315471.0,11117993360,1316124034,128363956,100227114.0,28136842.0,551377925425,529141938705,219925010206.0,132548211.0,7008734562.0
20190903,540321825192,22468521154,22406628027.0,61893127.0,11393615940,1310412878,101610598,107321754.0,-5711156.0,551715441132,528928209252,208983664262.0,139211175.0,17000352760.0
20190904,540978840534,26488975420,25831960078.0,657015342.0,11362719294,1329165907,128421553,109668524.0,18753029.0,552341559828,529616121240,239750911561.0,136227257.0,11723356224.0
20190905,542059512654,37240645540,36159973420.0,1080672120.0,11612179656,1338815746,155392513,145742674.0,9649839.0,553671692310,530447332998,331390574493.0,213172859.0,9972906453.0
20190906,541315600123,26293719864,27037632395.0,-743912531.0,11412789332,1290768095,103181090,151228741.0,-48047651.0,552728389455,529902810791,247445242820.0,120890026.0,11035143378.0
20190909,545831543383,33206188633,28690245373.0,4515943260.0,11660197020,1321451189,114199560,83516466.0,30683094.0,557491740403,534171346363,279995456326.0,156679077.0,7203403939.0
20190910,547266110610,30736436518,29301869291.0,1434567227.0,11568303313,1298127628,91928439,115252000.0,-23323561.0,558834413923,535697807297,268122670644.0,128645316.0,8084062433.0
20190911,548131519774,29042011279,28176602115.0,865409164.0,11779733982,1331203666,126601652,93525614.0,33076038.0,559911253756,536351785792,256829257625.0,157557713.0,6763169207.0
20190912,545974771941,24176204399,26332952232.0,-2156747833.0,11466782528,1319236084,112502594,124470176.0,-11967582.0,557441554469,534507989413,217448907160.0,119199955.0,7780427095.0
20190916,549029500599,27385289134,24330560476.0,3054728658.0,11563030260,1348217184,107602149,78621049.0,28981100.0,560592530859,537466470339,232843552420.0,86181675.0,4733099165.0
20190917,550022693898,25772659094,24779465795.0,993193299.0,10708483273,1290581159,109022546,166658571.0,-57636025.0,560731177171,539314210625,232482017669.0,131760537.0,5741400908.0
20190918,550256286908,19795887161,19562294151.0,233593010.0,10876374112,1289918069,126833738,127496828.0,-663090.0,561132661020,539379912796,194474166807.0,90842388.0,6686656446.0
20190919,551374200309,20221899437,19103986036.0,1117913401.0,11126705421,1297632816,113250029,105535282.0,7714747.0,562500905730,540247494888,186530763621.0,78253831.0,7122847241.0
20190920,550048535904,21047597684,22373262089.0,-1325664405.0,11211639118,1305998118,104270516,95905214.0,8365302.0,561260175022,538836896786,213822979316.0,145386036.0,5227062431.0
20190923,550826508305,20355243063,19577270662.0,777972401.0,11113215890,1289798619,107393054,123592553.0,-16199499.0,561939724195,539713292415,194027780125.0,88851211.0,5235322898.0
20190924,550171649766,21762642549,22417501088.0,-654858539.0,11030268233,1307153522,135674600,118319697.0,17354903.0,561201917999,539141381533,196995041896.0,92027950.0,9733225111.0
20190925,548262512825,19432741019,21341877960.0,-1909136941.0,10617077202,1278222915,104172494,133103101.0,-28930607.0,558879590027,537645435623,195274615544.0,84707946.0,9125990847.0
20190926,545878128202,19967035191,22351419814.0,-2384384623.0,10324609064,1265815151,106584955,118992719.0,-12407764.0,556202737266,535553519138,207820061578.0,129580938.0,9425278243.0
20190927,543547417610,13651850239,15982560831.0,-2330710592.0,10023846611,1213305033,70419158,122929276.0,-52510118.0,553571264221,533523570999,147796938960.0,61968448.0,5918346867.0
20190930,538791089316,11159059828,15915388122.0,-4756328294.0,9673381768,1186057417,59103589,86351205.0,-27247616.0,548464471084,529117707548,131417218853.0,71296715.0,11498802832.0
20191008,541173606913,15009332373,12626814776.0,2382517597.0,10309531518,1295605912,152761867,43213372.0,109548495.0,551483138431,530864075395,145718134987.0,101872839.0,6485933583.0
20191009,541990984143,14806074032,13988696802.0,817377230.0,10556972646,1317712247,126396777,104290442.0,22106335.0,552547956789,531434011497,146240793180.0,58242447.0,4840808520.0
20191010,542411429535,15468876503,15048431111.0,420445392.0,10968253874,1350734096,129787210,96765361.0,33021849.0,553379683409,531443175661,152015509362.0,132128203.0,5278633226.0
20191011,541053440557,18600737480,19958726458.0,-1357988978.0,11333591582,1376478811,129383565,103638850.0,25744715.0,552387032139,529719848975,178091516577.0,80137855.0,4979669767.0
20191014,544165541216,24627094056,21514993397.0,3112100659.0,11768306187,1419701966,143525090,100301935.0,43223155.0,555933847403,532397235029,215077894485.0,102081440.0,6693295380.0
20191015,543677569235,17158825976,17646797957.0,-487971981.0,11632742534,1407774789,90616662,102543839.0,-11927177.0,555310311769,532044826701,164796119452.0,58745143.0,5092719486.0
20191016,543790595150,17094350249,16981324334.0,113025915.0,11801770937,1435668069,110512436,82619156.0,27893280.0,555592366087,531988824213,160758551326.0,88402556.0,6204771356.0
20191017,543067159580,13069190384,13792625954.0,-723435570.0,11897000318,1450008002,94145421,79805488.0,14339933.0,554964159898,531170159262,131124099423.0,100784823.0,5423336122.0
20191018,541397950787,15610291452,17279500245.0,-1669208793.0,11593501055,1416633891,90305609,123679720.0,-33374111.0,552991451842,529804449732,155469718820.0,97291884.0,7108841563.0
20191021,541719877028,12901676433,12579750192.0,321926241.0,11605583690,1478047177,152331489,90918203.0,61413286.0,553325460718,530114293338,140240933794.0,73678979.0,6042249816.0
20191022,542455008256,12180569383,11445438155.0,735131228.0,11389398387,1471945881,106659390,112760686.0,-6101296.0,553844406643,531065609869,126413916023.0,65759116.0,4930454372.0
20191023,542590711121,13060167801,12924464936.0,135702865.0,11454460632,1494568237,114905572,92283216.0,22622356.0,554045171753,531136250489,131365336038.0,61762909.0,9919640470.0
20191024,543586678053,13490893210,12494926278.0,995966932.0,11123544614,1464298004,94452075,124722308.0,-30270233.0,554710222667,532463133439,135120530851.0,43236272.0,7901315478.0
20191025,543351773604,16219438581,16454343030.0,-234904449.0,10884799198,1421799599,98662974,141161379.0,-42498405.0,554236572802,532466974406,153474464279.0,85148635.0,6971408221.0
20191028,545352851087,21208661643,19207584160.0,2001077483.0,11152393907,1428472367,107814186,101141418.0,6672768.0,556505244994,534200457180,190008473016.0,83541882.0,9232729850.0
20191029,544786863040,19133429352,19699417399.0,-565988047.0,10781082019,1413383183,73172280,88261464.0,-15089184.0,555567945059,534005781021,186671066371.0,68005020.0,9189799114.0
20191030,544449761544,16601238273,16938339769.0,-337101496.0,10709021205,1411563382,88463226,90283027.0,-1819801.0,555158782749,533740740339,172357701740.0,50559076.0,9397026025.0
20191031,543040299737,16337590425,17747052232.0,-1409461807.0,10638733181,1410433123,83389350,84519609.0,-1130259.0,553679032918,532401566556,172764197026.0,70262714.0,9268331130.0
20191101,542675980074,17180068941,17544388604.0,-364319663.0,10900927115,1438066541,120952284,93318866.0,27633418.0,553576907189,531775052959,169933972205.0,85214759.0,6212566538.0
20191104,543020295419,19072530921,18728215576.0,344315345.0,11102164516,1477482548,106053387,66637380.0,39416007.0,554122459935,531918130903,184112660578.0,96684073.0,6189020116.0
20191105,544029029680,20647451367,19638717106.0,1008734261.0,11272890053,1490498916,109679915,96663547.0,13016368.0,555301919733,532756139627,194102878833.0,93597489.0,11233239945.0
20191106,543999526706,18100800898,18130303872.0,-29502974.0,11336704592,1505732872,104254943,89020987.0,15233956.0,555336231298,532662822114,172434771578.0,95303039.0,12044229198.0
20191107,544188094794,15533015247,15344447159.0,188568088.0,11468432102,1511237167,93689274,88184979.0,5504295.0,555656526896,532719662692,145450377009.0,67390573.0,11538879655.0
20191108,543255280042,17667708660,18600523412.0,-932814752.0,11276338194,1468819140,87545628,129963655.0,-42418027.0,554531618236,531978941848,163031057548.0,75859844.0,11111615467.0
20191111,541755441181,15099217868,16599056729.0,-1499838861.0,10797278670,1461309318,94053832,101563654.0,-7509822.0,552552719851,530958162511,156719905769.0,78901700.0,9799811523.0
20191112,541360163467,12473968511,12869246225.0,-395277714.0,10823777899,1463070655,100984321,99222984.0,1761337.0,552183941366,530536385568,132026534138.0,61103697.0,7482070751.0
20191113,542048023809,13852658050,13164797708.0,687860342.0,11005876873,1466268483,107378800,104180972.0,3197828.0,553053900682,531042146936,139549975186.0,46919220.0,7809403179.0
20191114,542725646617,14366003115,13688380307.0,677622808.0,11132049828,1498391565,128526310,96403228.0,32123082.0,553857696445,531593596789,143575663055.0,49835803.0,8705226081.0
20191115,541112917831,13435659119,15048387905.0,-1612728786.0,10748849005,1458053476,85193088,125531177.0,-40338089.0,551861766836,530364068826,143764856767.0,46860466.0,9431541093.0
20191118,541533326643,13134767176,12714358364.0,420408812.0,10960017504,1488430040,98174137,67797573.0,30376564.0,552493344147,530573309139,132621405482.0,66177818.0,12563428508.0
20191119,542721380946,15358198943,14170144640.0,1188054303.0,10980386765,1459432483,88401247,117398804.0,-28997557.0,553701767711,531740994181,148185836799.0,68625350.0,8059363756.0
20191120,543039825777,15424142725,15105697894.0,318444831.0,10781914417,1446103257,78454478,91783704.0,-13329226.0,553821740194,532257911360,151481333700.0,57087953.0,9169503287.0
20191121,544024320788,13785300418,12800805407.0,984495011.0,10841484084,1477321159,117840892,86622990.0,31217902.0,554865804872,533182836704,131538411213.0,42104933.0,8565660719.0
20191122,542558701610,17908370560,19373989738.0,-1465619178.0,10591990623,1453759192,110304324,133866291.0,-23561967.0,553150692233,531966710987,172718554176.0,93535314.0,8091305382.0
20191125,542994841271,17083962116,16647822455.0,436139661.0,10841632264,1504943312,137074241,85890121.0,51184120.0,553836473535,532153209007,168651109568.0,158062710.0,6470759428.0
20191126,541048628299,11852995009,13799207981.0,-1946212972.0,10917987011,1514266671,96442723,87119364.0,9323359.0,551966615310,530130641288,161090131712.0,259585928.0,4479046476.0
20191127,541540132118,12741492721,12249988902.0,491503819.0,10974380903,1520163466,94772628,88875833.0,5896795.0,552514513021,530565751215,132906602448.0,102604847.0,4957026140.0
20191128,540557833985,10775496820,11757794953.0,-982298133.0,10982996908,1524787250,95713107,91089323.0,4623784.0,551540830893,529574837077,117204914595.0,68709822.0,5926998024.0
20191129,540589918492,12991522208,12959437701.0,32084507.0,10569738432,1441946376,90454610,173295484.0,-82840874.0,551159656924,530020180060,135243146795.0,178125410.0,5166856430.0
20191202,540793588479,12560008717,12356338730.0,203669987.0,10612426512,1470760045,118497814,89684145.0,28813669.0,551406014991,530181161967,134240629244.0,74125191.0,5193451862.0
20191203,541820549640,12801148711,11774187550.0,1026961161.0,10647205327,1477914576,107441067,100286536.0,7154531.0,552467754967,531173344313,129818894828.0,60855461.0,6153296909.0
20191204,542474281717,13279715249,12625983172.0,653732077.0,10660723132,1470526895,102076170,109463851.0,-7387681.0,553135004849,531813558585,130176490908.0,61614701.0,6147095952.0
20191205,542948225200,15459928808,14985985325.0,473943483.0,10685864537,1441954965,107604853,136176783.0,-28571930.0,553634089737,532262360663,154061187505.0,84847172.0,6252950445.0
20191206,542900227729,14616539198,14664536669.0,-47997471.0,10726461920,1444561455,98802670,96196180.0,2606490.0,553626689649,532173765809,143879203841.0,63716112.0,5806202428.0
20191209,543860276636,17900924528,16940875621.0,960048907.0,10790307026,1445576172,100396834,99382117.0,1014717.0,554650583662,533069969610,165256839981.0,91471556.0,9752994832.0
20191210,544324601840,16553966156,16089640952.0,464325204.0,10955300849,1447008017,105260612,103828767.0,1431845.0,555279902689,533369300991,163809426698.0,57372535.0,17689093986.0
20191211,544826951629,17600728458,17098378669.0,502349789.0,11075497150,1471918166,126737025,101826876.0,24910149.0,555902448779,533751454479,163620917929.0,44563786.0,12981550833.0
20191212,544762356034,15711214718,15775810313.0,-64595595.0,10838303677,1449227888,87173923,109864201.0,-22690278.0,555600659711,533924052357,156858336176.0,56610627.0,9823499066.0
20191213,544431163367,23244118842,23575311509.0,-331192667.0,10983715047,1444631533,125984881,130581236.0,-4596355.0,555414878414,533447448320,226395576490.0,113108389.0,7896058894.0
20191216,548288053609,27740021378,23883131136.0,3856890242.0,10964588638,1453192249,113223026,104662310.0,8560716.0,559252642247,537323464971,229895776510.0,152369964.0,8203648612.0
20191217,551516610507,35126663542,31898106644.0,3228556898.0,11152939293,1457433748,152548014,148306515.0,4241499.0,562669549800,540363671214,292869397188.0,205608208.0,10065907482.0
20191218,554466188124,29684776793,26735199176.0,2949577617.0,11107457966,1413650473,122335778,166119053.0,-43783275.0,565573646090,543358730158,244714290819.0,115945438.0,14819368459.0
20191219,556309366942,24116730229,22273551411.0,1843178818.0,10986525236,1403640067,102483602,112494008.0,-10010406.0,567295892178,545322841706,210440482485.0,113746391.0,11125279692.0
20191220,555035446253,23989420203,25263340892.0,-1273920689.0,10699260739,1370612694,90852504,123879877.0,-33027373.0,565734706992,544336185514,214438406320.0,139129817.0,9189105841.0
20191223,556003821374,23047433720,22079058599.0,968375121.0,10274213691,1348942900,120141931,141811725.0,-21669794.0,566278035065,545729607683,209558773879.0,101503121.0,10839865909.0
20191224,554400951209,18060475599,19663345764.0,-1602870165.0,10351193007,1351656004,129289560,126576456.0,2713104.0,564752144216,544049758202,161047036509.0,68604057.0,6987676278.0
20191225,555015167639,21470493409,20856276979.0,614216430.0,10617458513,1376783886,121723569,96595687.0,25127882.0,565632626152,544397709126,181841196237.0,62968030.0,10742620487.0
20191226,555995394376,23272150392,22291923655.0,980226737.0,10768745221,1415181275,138329500,99932111.0,38397389.0,566764139597,545226649155,187747940192.0,79561771.0,10672148863.0
20191227,555111529883,29198997533,30082862026.0,-883864493.0,10728653748,1437175167,141021546,119027654.0,21993892.0,565840183631,544382876135,249079104243.0,91719630.0,9814004683.0
20191230,558917674707,33037624018,29231479194.0,3806144824.0,10977853200,1444706324,144365707,136834550.0,7531157.0,569895527907,547939821507,261070700480.0,122175334.0,8215424251.0
20191231,559055426838,25568407895,25430655764.0,137752131.0,10892767928,1447051229,129981453,127636548.0,2344905.0,569948194766,548162658910,220142657318.0,137183141.0,6821138656.0
20200102,561396722311,39665569600,37324274127.0,2341295473.0,11292893947,1490508270,168868829,125411788.0,43457041.0,572689616258,550103828364,318760355851.0,162830313.0,9320218645.0
20200103,562710881010,33474395954,32160237255.0,1314158699.0,10918911096,1435983771,109430958,163955457.0,-54524499.0,573629792106,551791969914,280623660905.0,87649343.0,9681370654.0
20200106,567760802437,39971310371,34921388944.0,5049921427.0,11193485547,1474025681,171138826,133096916.0,38041910.0,578954287984,556567316890,319699832423.0,110767418.0,11982362857.0
20200107,568793261762,32940743825,31908284500.0,1032459325.0,11143113227,1455991934,144904491,162938238.0,-18033747.0,579936374989,557650148535,276904573387.0,149432836.0,11960129130.0
20200108,570740658657,35809712248,33862315353.0,1947396895.0,10510224534,1394737021,155611085,216865998.0,-61254913.0,581250883191,560230434123,293501930843.0,133900834.0,13511280832.0
20200109,571819012961,31039484561,29961130257.0,1078354304.0,10520442935,1375596816,146253476,165393681.0,-19140205.0,582339455896,561298570026,259354253596.0,121737231.0,12920742771.0
20200110,570739934602,26873586822,27952665181.0,-1079078359.0,10298596512,1351861829,125463113,149198100.0,-23734987.0,581038531114,560441338090,231492275659.0,87057825.0,10771413652.0
20200113,573021434835,31004102581,28722602348.0,2281500233.0,10507325406,1378978778,151862524,124745575.0,27116949.0,583528760241,562514109429,247452485421.0,180697095.0,11693842674.0
20200114,574945207770,31344441336,29420668401.0,1923772935.0,10491659685,1373527039,132289083,137740822.0,-5451739.0,585436867455,564453548085,256643484089.0,111187205.0,15309517426.0
20200115,575929132790,26948638728,25964713708.0,983925020.0,10022583450,1303001970,104965738,175490807.0,-70525069.0,585951716240,565906549340,221571981760.0,108801061.0,11557143999.0
20200116,576558354303,25940815347,25311593834.0,629221513.0,9707122701,1221476856,77798384,159323498.0,-81525114.0,586265477004,566851231602,221061969602.0,134231361.0,16123718853.0
20200117,575491812969,25894205952,26960747286.0,-1066541334.0,9769443013,1215946775,102038655,107568736.0,-5530081.0,585261255982,565722369956,216316878856.0,86197285.0,26087616014.0
20200120,576303022728,31214023833,30402814074.0,811209759.0,9795394680,1199160052,86523162,103309885.0,-16786723.0,586098417408,566507628048,245475060310.0,98980684.0,25899623236.0
20200121,576301105902,32678736729,32680653555.0,-1916826.0,9324777990,1131694540,78871039,146336551.0,-67465512.0,585625883892,566976327912,265604763570.0,138463110.0,20830667179.0
20200122,576330861708,31496052112,31466296306.0,29755806.0,8897364678,1088204785,88170687,131660442.0,-43489755.0,585228226386,567433497030,255458667490.0,143762884.0,23134720395.0
20200123,568373798279,34244816895,42201880324.0,-7957063429.0,7983489656,990888122,60154447,157471110.0,-97316663.0,576357287935,560390308623,303387439086.0,248732868.0,23908502002.0
20200203,561975455459,24109695957,30508038777.0,-6398342820.0,6552228192,937514913,30463860,83837069.0,-53373209.0,568527683651,555423227267,234445860743.0,299307851.0,22397385435.0
20200204,559952837462,35461810593,37484428590.0,-2022617997.0,6523438866,898811733,8797144,47500324.0,-38703180.0,566476276328,553429398596,348687671774.0,307386933.0,25223979536.0
20200205,559232297605,34111829016,34832368873.0,-720539857.0,6720508658,907084280,20452355,12179808.0,8272547.0,565952806263,552511788947,318182798045.0,217085959.0,31245312402.0
20200206,562022699504,38529608000,35739206101.0,2790401899.0,6767457936,902348168,21876515,26612627.0,-4736112.0,568790157440,555255241568,329697062305.0,226501910.0,28906714090.0
20200207,561920858486,37686809856,37788650874.0,-101841018.0,6781955757,892168591,12658396,22837973.0,-10179577.0,568702814243,555138902729,330007880369.0,185835782.0,32398485341.0
20200210,563895597858,36246045806,34271306434.0,1974739372.0,7327030143,948104632,89381236,33445195.0,55936041.0,571222628001,556568567715,311627194770.0,201135203.0,30067742466.0
20200211,562460299122,30460935925,31896234661.0,-1435298736.0,8019682181,1030091238,123344161,41357555.0,81986606.0,570479981303,554440616941,276791190905.0,102327293.0,26640836627.0
20200212,564705327037,33501425705,31256397790.0,2245027915.0,8901457391,1121672459,147358558,55777337.0,91581221.0,573606784428,555803869646,270055839564.0,116792984.0,27617834731.0
20200213,565269286069,36519148029,35955188997.0,563959032.0,9092676707,1133619420,106038388,94091427.0,11946961.0,574361962776,556176609362,299533806090.0,117445395.0,35061735656.0
20200214,564842574521,35262531666,35689243214.0,-426711548.0,9399512538,1153986079,106083603,85716944.0,20366659.0,574242087059,555443061983,277781874121.0,105221916.0,30507201681.0
20200217,568927550285,43034434520,38949458756.0,4084975764.0,9982728806,1185340151,133901551,102547479.0,31354072.0,578910279091,558944821479,339232832780.0,145304300.0,27964027514.0
20200218,573602028083,44582485006,39908007208.0,4674477798.0,10232506176,1219049007,132178888,98470032.0,33708856.0,583834534259,563369521907,343802072082.0,122296176.0,31455463043.0
20200219,574072376028,44611198356,44140850411.0,470347945.0,10416491507,1273518468,132541902,78072441.0,54469461.0,584488867535,563655884521,352062350797.0,109483759.0,29399866008.0
20200220,577770431812,50651791080,46953735296.0,3698055784.0,10754071099,1301360101,155046392,127204759.0,27841633.0,588524502911,567016360713,389203650005.0,166345561.0,25504797414.0
20200221,579970674213,54790838593,52590596192.0,2200242401.0,10921373087,1285189680,120527624,136698045.0,-16170421.0,590892047300,569049301126,412645579894.0,156280460.0,32808655097.0
20200224,586415776616,56662525057,50217422654.0,6445102403.0,11231601726,1351973514,180154403,113370569.0,66783834.0,597647378342,575184174890,426146541150.0,161878586.0,27249529021.0
20200225,590115848980,62412767506,58712695142.0,3700072364.0,11318963864,1343936397,173767566,181804683.0,-8037117.0,601434812844,578796885116,484044499915.0,234314169.0,29211180771.0
20200226,591118726025,59482019923,58479142878.0,1002877045.0,11405888789,1396921409,213870435,160885423.0,52985012.0,602524614814,579712837236,466629403692.0,181766268.0,28845030671.0
20200227,589914863168,43639489627,44843352484.0,-1203862857.0,11370281903,1373727551,145391292,168585150.0,-23193858.0,601285145071,578544581265,367735132539.0,156260606.0,28448830850.0
20200228,582209646574,42695281497,50400498091.0,-7705216594.0,10550966306,1317477434,183296830,239546947.0,-56250117.0,592760612880,571658680268,405658766821.0,259479909.0,27560512530.0
20200302,584892862349,45691129457,43007913682.0,2683215775.0,11088678301,1339469696,212427693,190435431.0,21992262.0,595981540650,573804184048,373256836995.0,206692964.0,24248763051.0
20200303,587708596032,54347170867,51531437184.0,2815733683.0,11691238927,1411929761,227521357,155061292.0,72460065.0,599399834959,576017357105,419763255496.0,178066055.0,27545997994.0
20200304,589223256850,44052510624,42537849806.0,1514660818.0,11715841728,1432677528,188052945,167305178.0,20747767.0,600939098578,577507415122,368870875718.0,116230817.0,21545066461.0
20200305,594628864283,59739363828,54333756395.0,5405607433.0,12441415101,1541224525,249898827,141351830.0,108546997.0,607070279384,582187449182,462979521232.0,186021000.0,20753081802.0
20200306,590460217993,40921467877,45090114167.0,-4168646290.0,11697981525,1481925727,121020326,180319124.0,-59298798.0,602158199518,578762236468,362125327778.0,108886235.0,16888877789.0
20200309,591181177560,47356173135,46635213568.0,720959567.0,11431440825,1554248499,233183514,160860742.0,72322772.0,602612618385,579749736735,419543821835.0,177944172.0,18882083126.0
20200310,591394308733,46881445479,46668314306.0,213131173.0,11428906521,1434003889,186496966,306741576.0,-120244610.0,602823215254,579965402212,404469097455.0,194652811.0,20642776089.0
20200311,590756731201,42546395028,43183972560.0,-637577532.0,11804392633,1560136974,277240794,151107709.0,126133085.0,602561123834,578952338568,360934204459.0,103828410.0,18155380727.0
20200312,589062499522,34930386707,36624618386.0,-1694231679.0,11611034849,1568344794,209309116,201101296.0,8207820.0,600673534371,577451464673,315604017208.0,150227049.0,13234007795.0
20200313,585866095442,40253720911,43450124991.0,-3196404080.0,11354864353,1503010536,204700818,270035076.0,-65334258.0,597220959795,574511231089,375154116007.0,214996986.0,17861057334.0
20200316,578948250524,35878076855,42795921773.0,-6917844918.0,11168216763,1588578124,268008438,182440850.0,85567588.0,590116467287,567780033761,359278605890.0,187814234.0,16933590693.0
20200317,579300265730,31973698009,31621682803.0,352015206.0,10818556171,1485261271,199130211,302447064.0,-103316853.0,590118821901,568481709559,307942763163.0,170095617.0,15478246347.0
20200318,575453741797,31406343302,35252867235.0,-3846523933.0,11420378410,1666270724,333526732,152517279.0,181009453.0,586874120207,564033363387,302794550215.0,135911599.0,15909223560.0
20200319,576795028671,33760354753,32419067879.0,1341286874.0,11128823487,1559624298,197084236,303730662.0,-106646426.0,587923852158,565666205184,316063046303.0,167162159.0,14461021561.0
20200320,573455088179,25780281341,29120221833.0,-3339940492.0,11346890936,1566882344,200164163,192906117.0,7258046.0,584801979115,562108197243,268689494448.0,144907626.0,13149134176.0
20200323,569697127931,24130274917,27888235165.0,-3757960248.0,11132685684,1600599374,211409817,177692787.0,33717030.0,580829813615,558564442247,254619216716.0,151072893.0,13994697335.0
20200324,568532351819,25675496483,26840272595.0,-1164776112.0,11320671610,1560513994,169292223,209377603.0,-40085380.0,579853023429,557211680209,266971252045.0,135345432.0,12170476390.0
20200325,569239231247,29705703083,28998823655.0,706879428.0,12000239629,1671376427,245364293,134501860.0,110862433.0,581239470876,557238991618,281357710821.0,128284705.0,12440999656.0
20200326,567775129391,23466311560,24930413416.0,-1464101856.0,12316132506,1762193307,229909484,139092604.0,90816880.0,580091261897,555458996885,237840680958.0,88918033.0,10989329495.0
20200327,565477732570,24403231198,26700628019.0,-2297396821.0,12299462107,1750427521,189313139,201078925.0,-11765786.0,577777194677,553178270463,243205467775.0,97918127.0,10644203492.0
20200330,564031495104,22576159335,24022396801.0,-1446237466.0,11993510332,1730500294,164653551,184580778.0,-19927227.0,576025005436,552037984772,239812339775.0,106887044.0,11067592745.0
20200331,562713019950,20744436959,22062912113.0,-1318475154.0,12388253833,1795420131,196854474,131934637.0,64919837.0,575101273783,550324766117,215624346516.0,64280082.0,8727209117.0
20200401,559305882671,19697942546,23105079825.0,-3407137279.0,12595285666,1840792791,189262236,143889576.0,45372660.0,571901168337,546710597005,217133443902.0,54425507.0,8834171593.0
20200402,558526402294,21662678601,22442158978.0,-779480377.0,12826845911,1811795579,155578788,184576000.0,-28997212.0,571353248205,545699556383,222273443364.0,75761013.0,11151637258.0
20200403,554642771517,18410396097,22294026874.0,-3883630777.0,12564550797,1832289979,162650722,142156322.0,20494400.0,567207322314,542078220720,204860621960.0,55694270.0,9304559263.0
20200407,556005279122,29027163780,27664656175.0,1362507605.0,13249670300,1901657369,205019454,135652064.0,69367390.0,569254949422,542755608822,276839259920.0,136217949.0,9758289104.0
20200408,555044653995,23631666517,24592291644.0,-960625127.0,13362414398,1933276828,179835698,148216239.0,31619459.0,568407068393,541682239597,244770405571.0,82595886.0,8426888109.0
20200409,555131422688,24940682994,24853914301.0,86768693.0,14059883513,2040805216,210901066,103372678.0,107528388.0,569191306201,541071539175,237905835354.0,61283641.0,9596321378.0
20200410,552122826513,23901918992,26910515167.0,-3008596175.0,13878515875,2077428751,196191369,159567834.0,36623535.0,566001342388,538244310638,235544631518.0,60235314.0,10923121107.0
20200413,551402967203,17122642107,17842501417.0,-719859310.0,13890502521,2111020249,157212642,123621144.0,33591498.0,565293469724,537512464682,177003439704.0,78348072.0,7144642065.0
20200414,551453038319,20580637053,20530565937.0,50071116.0,14242299495,2118843845,195593647,187770051.0,7823596.0,565695337814,537210738824,-100000000.0,-100000000.0,-100000000.0
20200415,551400055359,22033432563,22086415523.0,-52982960.0,14100736265,2119067323,172298558,172075080.0,223478.0,565500791624,537299319094,223076892323.0,70259863.0,9013243293.0
20200416,552724896743,22311172284,20986330900.0,1324841384.0,14274813311,2110017110,171608829,180659042.0,-9050213.0,566999710054,538450083432,213772664827.0,73628587.0,8720935815.0
20200417,551148283066,27927304450,29503918127.0,-1576613677.0,14591362491,2151090517,202428496,161355089.0,41073407.0,565739645557,536556920575,268049334984.0,83846974.0,12163517563.0
20200420,552092865833,22155303147,21210720380.0,944582767.0,15046194193,2211138220,175716752,115669049.0,60047703.0,567139060026,537046671640,222051656124.0,86810348.0,11805754207.0
20200421,552024405126,23840199938,23908660645.0,-68460707.0,15081371939,2270582434,182849256,123405042.0,59444214.0,567105777065,536943033187,238122729842.0,74513300.0,10683030979.0
20200422,552974194763,21815366141,20865576504.0,949789637.0,15503800347,2303866316,159447749,126163867.0,33283882.0,568477995110,537470394416,221305344575.0,92157620.0,11816743570.0
20200423,552995180646,23547042759,23526056876.0,20985883.0,15556897570,2340955792,145016533,107927057.0,37089476.0,568552078216,537438283076,248595387317.0,59521791.0,14295796134.0
20200424,550033499023,20653564238,23615245861.0,-2961681623.0,15154930270,2264563881,113936501,190328412.0,-76391911.0,565188429293,534878568753,230709549625.0,52370502.0,13549039374.0
20200427,549190163750,19726959881,20570295154.0,-843335273.0,15372801801,2316237097,168252317,116579101.0,51673216.0,564562965551,533817361949,212335863534.0,53167012.0,13560603712.0
20200428,546719357234,24084402812,26555209328.0,-2470806516.0,15393454190,2323607664,197935682,190565115.0,7370567.0,562112811424,531325903044,252940749378.0,129425886.0,17849027840.0
20200429,543684772162,20903912083,23938497155.0,-3034585072.0,15375592530,2345150166,157497464,135954962.0,21542502.0,559060364692,528309179632,210624630090.0,119717569.0,12315032161.0
20200430,540087048500,27301197826,30898921488.0,-3597723662.0,15146808419,2238389479,113194596,219955283.0,-106760687.0,555233856919,524940240081,260243164048.0,154413511.0,17161752933.0
20200506,546427698550,31340468220,24999818170.0,6340650050.0,15877403656,2282299095,159606290,115696674.0,43909616.0,562305102206,530550294894,280010582251.0,128876483.0,24208887072.0
20200507,548983059716,26876926878,24321565712.0,2555361166.0,16343509394,2373983367,182497813,90813541.0,91684272.0,565326569110,532639550322,246312550838.0,100510246.0,22563245242.0
20200508,550055155563,29206285529,28134189682.0,1072095847.0,16625161563,2335661760,120763294,159084901.0,-38321607.0,566680317126,533429994000,255788085265.0,99377729.0,21033838749.0
20200511,553137209402,28261481153,25179427314.0,3082053839.0,17038053566,2414690941,186646482,107617301.0,79029181.0,570175262968,536099155836,252813680544.0,118160309.0,19269660744.0
20200512,554421178255,22869141226,21585172373.0,1283968853.0,17150465810,2411432632,153247628,156505937.0,-3258309.0,571571644065,537270712445,221094623372.0,332306728.0,17352389594.0
20200513,554829513206,20992712377,20584377426.0,408334951.0,17561035424,2473026500,162317600,100723732.0,61593868.0,572390548630,537268477782,205281907642.0,217736296.0,18810321528.0
20200514,555669875057,22639567863,21799206012.0,840361851.0,17676989860,2487338135,127985541,113673906.0,14311635.0,573346864917,537992885197,217737589071.0,115151417.0,20569651882.0
20200515,555066959688,23634951499,24237866868.0,-602915369.0,17405073381,2373921204,105358929,218775860.0,-113416931.0,572472033069,537661886307,226138218555.0,97927431.0,21400677492.0
20200518,556568601275,28257957499,26756315912.0,1501641587.0,17901672127,2460073719,175441999,89289484.0,86152515.0,574470273402,538666929148,262947317339.0,241713616.0,26668433471.0
20200519,558516802310,26625304248,24677103213.0,1948201035.0,18292774157,2477246097,152950926,135778548.0,17172378.0,576809576467,540224028153,231270638424.0,145631591.0,25390588053.0
20200520,558071029282,25707860106,26153633134.0,-445773028.0,18353112907,2508782159,145517489,113981427.0,31536062.0,576424142189,539717916375,240610233268.0,118349550.0,28726644066.0
20200521,557611667024,23010495437,23469857695.0,-459362258.0,18222270406,2524710129,134036774,118108804.0,15927970.0,575833937430,539389396618,226397490862.0,113521318.0,24677055450.0
20200522,556339825469,22627019165,23898860720.0,-1271841555.0,17692725636,2498802660,137287701,163195170.0,-25907469.0,574032551105,538647099833,224827392908.0,124884480.0,20624874419.0
20200525,556476814207,17463239847,17326251109.0,136988738.0,17654210985,2532465031,131964596,98302225.0,33662371.0,574131025192,538822603222,186505473667.0,122491435.0,16459720486.0
20200526,557499732122,18243331094,17220413179.0,1022917915.0,18226328693,2571740036,180625950,141350945.0,39275005.0,575726060815,539273403429,187350729654.0,228333196.0,20627949954.0
20200527,557552127210,20015094791,19962699703.0,52395088.0,18486941223,2644806991,187917546,114850591.0,73066955.0,576039068433,539065185987,206621225916.0,116697259.0,21592431037.0
20200528,556679561665,20995560490,21868126035.0,-872565545.0,18816728323,2689167514,148722169,104361646.0,44360523.0,575496289988,537862833342,218472078793.0,120735602.0,21210536720.0
20200529,555018097562,19238870510,20900334613.0,-1661464103.0,19040519488,2722088930,139699902,106778486.0,32921416.0,574058617050,535977578074,212179073220.0,209114096.0,22367678896.0
20200601,559577690993,31631706362,27072112931.0,4559593431.0,19599773364,2676981427,123586027,168693530.0,-45107503.0,579177464357,539977917629,281616162956.0,168678644.0,26150221995.0
20200602,560049208115,27655143944,27183626822.0,471517122.0,19766677439,2717711645,150550196,109819978.0,40730218.0,579815885554,540282530676,268162015266.0,130996807.0,26338193783.0
20200603,560353938047,28347745184,28043015252.0,304729932.0,19691409939,2694539366,116230832,139403111.0,-23172279.0,580045347986,540662528108,274192756309.0,391120804.0,26362601004.0
20200604,562154767159,24375601180,22574772068.0,1800829112.0,19865720591,2744718466,139017894,88838794.0,50179100.0,582020487750,542289046568,228123783562.0,141574457.0,26661651242.0
20200605,562693813584,24381448548,23842402123.0,539046425.0,19816808151,2751046118,143771110,137443458.0,6327652.0,582510621735,542877005433,229540663369.0,130744267.0,23976196042.0
20200608,564623246283,26725075721,24795643022.0,1929432699.0,20041409794,2803788393,163764696,111022421.0,52742275.0,584664656077,544581836489,250558290470.0,176264852.0,24498157320.0
20200609,565324951356,23252995272,22551290199.0,701705073.0,20309613666,2824688131,145300195,124400457.0,20899738.0,585634565022,545015337690,230102276073.0,119080718.0,21822379222.0
20200610,566139309135,22426053065,21611695286.0,814357779.0,20411854037,2864767563,146116033,106036601.0,40079432.0,586551163172,545727455098,221455723135.0,106484212.0,22723270097.0
20200611,567697168308,27707978727,26150119554.0,1557859173.0,20639926290,2900235189,150273641,114806015.0,35467626.0,588337094598,547057242018,265394204041.0,163471720.0,24507445516.0
20200612,567784675205,25245172617,25157665720.0,87506897.0,20444785037,2887442138,153551087,166344138.0,-12793051.0,588229460242,547339890168,252422556043.0,125665630.0,22122202254.0
20200615,569218261248,28010468536,26576882493.0,1433586043.0,20658576583,2939099272,165910546,114253412.0,51657134.0,589876837831,548559684665,270394312868.0,147490517.0,22964188425.0
20200616,571708480538,27293210690,24802991400.0,2490219290.0,21198109730,2951765795,172115498,159448975.0,12666523.0,592906590268,550510370808,246078614852.0,126956826.0,25795650449.0
20200617,572629011059,26967131825,26046601304.0,920530521.0,21737615310,2993084453,166614433,125295775.0,41318658.0,594366626369,550891395749,252890956869.0,133017674.0,26092245874.0
20200618,574702654882,30004790919,27931147096.0,2073643823.0,22076853179,3006520158,164461112,151025407.0,13435705.0,596779508061,552625801703,265943652449.0,182282741.0,24194728170.0
20200619,574584041996,32350124280,32468737166.0,-118612886.0,21883528063,2875398255,138359842,269481745.0,-131121903.0,596467570059,552700513933,298731771118.0,202398370.0,23073914259.0
20200622,579997002944,38542084417,33129123469.0,5412960948.0,22440958515,2873748861,160481169,162130563.0,-1649394.0,602437961459,557556044429,312507724182.0,147939362.0,33911210414.0
20200623,582362137952,32250630317,29885495309.0,2365135008.0,22842179983,2913100707,200122253,160770407.0,39351846.0,605204317935,559519957969,277592300108.0,127107706.0,28896562537.0
20200624,578986495858,29214194352,32589836446.0,-3375642094.0,22721280148,2890345192,145468956,168224471.0,-22755515.0,601707776006,556265215710,266280345636.0,137576976.0,31510936881.0
20200629,583149719849,30378396073,26215172082.0,4163223991.0,22596962927,2913521799,152798833,129622226.0,23176607.0,605746682776,560552756922,269218798438.0,99580992.0,25545765385.0
20200630,588541166170,37148889306,31757442985.0,5391446321.0,23225333319,2934997254,185711804,164236349.0,21475455.0,611766499489,565315832851,269200239301.0,103428781.0,28959202326.0
20200701,593499380417,45796675255,40838461008.0,4958214247.0,24288816962,3081730913,285129448,138395789.0,146733659.0,617788197379,569210563455,337516741203.0,128139036.0,33230832559.0
20200702,599389899784,55991742719,50101223352.0,5890519367.0,24857923277,3028360649,222335011,275705275.0,-53370264.0,624247823061,574531976507,446433079048.0,249253713.0,32387656939.0
20200703,606187612076,65531619065,58733906773.0,6797712292.0,25291043834,3053992521,248589004,222957132.0,25631872.0,631478655910,580896568242,504207936458.0,246771047.0,31717314417.0
20200706,627556881275,94920843388,73551574189.0,21369269199.0,26892935690,3022533689,298919742,330378574.0,-31458832.0,654449816965,600663945585,678068930246.0,489652083.0,46138076259.0
20200707,640490679043,100048804583,87115006815.0,12933797768.0,26708307238,2906050374,269008163,385491478.0,-116483315.0,667198986281,613782371805,738737709647.0,453781373.0,55726346138.0
20200708,657755813850,93339326675,76074191868.0,17265134807.0,28108136154,2972596371,330721452,264175455.0,66545997.0,685863950004,629647677696,652700989223.0,405260052.0,45019371127.0
20200709,669814955947,101080373908,89021231811.0,12059142097.0,28783810047,2985237576,292979495,280338290.0,12641205.0,698598765994,641031145900,695189147447.0,415348247.0,57641902136.0
20200710,678735135575,91251348273,82331168645.0,8920179628.0,28018816781,2939391237,258183788,304030127.0,-45846339.0,706753952356,650716318794,653222231351.0,344357213.0,50625185929.0
20200713,693969954893,95775836288,80541016970.0,15234819318.0,29193995414,2999854003,346574249,286111483.0,60462766.0,723163950307,664775959479,665297704159.0,326056810.0,52826267402.0
20200714,700304768072,87080935672,80746122493.0,6334813179.0,28799866749,2907350265,305787290,398291028.0,-92503738.0,729104634821,671504901323,645420102602.0,324903229.0,62036296002.0
20200715,703088755528,79253823624,76469836168.0,2783987456.0,28396318145,2942837071,307538473,272051667.0,35486806.0,731485073673,674692437383,607417902062.0,294098781.0,68085046111.0
20200716,701564857416,72455893119,73979791231.0,-1523898112.0,27127683849,2892204370,313713784,364346485.0,-50632701.0,728692541265,674437173567,583441598564.0,319549279.0,97448868864.0
20200717,696844708851,47549848559,52269997124.0,-4720148565.0,27039379780,2848098766,264640177,308745781.0,-44105604.0,723884088631,669805329071,430830775783.0,239464103.0,56043462471.0
20200720,701056904736,60722523027,56510327142.0,4212195885.0,29142336350,3016715457,374734434,206117743.0,168616691.0,730199241086,671914568386,486102077600.0,273676508.0,57921256754.0
20200721,701417603825,53598876864,53238177775.0,360699089.0,29649465360,3090810575,290091255,215996137.0,74095118.0,731067069185,671768138465,440032384587.0,186175204.0,49959692538.0
20200722,704025960797,60654693446,58046336474.0,2608356972.0,30584549816,3147297924,333713454,277226105.0,56487349.0,734610510613,673441410981,477521813806.0,218905044.0,65048193908.0
20200723,708063785728,63461931223,59424106292.0,4037824931.0,30602804283,3213785309,312236166,245748781.0,66487385.0,738666590011,677460981445,490701568085.0,199837229.0,58033475087.0
20200724,700715314451,60354064866,67702536143.0,-7348471277.0,29163570123,3252209184,322993668,284569793.0,38423875.0,729878884574,671551744328,525781468410.0,215516839.0,58783030725.0
20200727,703259741449,43207902291,40663475293.0,2544426998.0,29478693733,3318883565,298401126,231726745.0,66674381.0,732738435182,673781047716,364509728386.0,154708604.0,38525707455.0
20200728,703851065382,41294371024,40703047091.0,591323933.0,30282021131,3440113732,301593210,180363043.0,121230167.0,734133086513,673569044251,356778945245.0,115122785.0,34089714374.0
20200729,709581445856,53062685862,47332305388.0,5730380474.0,31690902150,3402750725,241098134,278461141.0,-37363007.0,741272348006,677890543706,405923729595.0,152835311.0,49639629239.0
20200730,712590778640,54741149053,51731816269.0,3009332784.0,32332813204,3495351043,259054463,166454145.0,92600318.0,744923591844,680257965436,427367780659.0,163775751.0,51340027141.0
20200731,715121775818,56445034914,53914037736.0,2530997178.0,32837176033,3480507044,272717385,287561384.0,-14843999.0,747958951851,682284599785,436905115283.0,143082708.0,59704012989.0
20200803,725137948042,70046682051,60030509827.0,10016172224.0,34424485120,3563045769,316679138,234140413.0,82538725.0,759562433162,690713462922,506057829411.0,210085435.0,66990700284.0
20200804,725683475209,70004717047,69459189880.0,545527167.0,35317571125,3666750500,309137465,205432734.0,103704731.0,761001046334,690365904084,551289348250.0,185433856.0,55168409833.0
20200805,732690221755,63615720413,56608973867.0,7006746546.0,36604455998,3736982532,297156705,226924673.0,70232032.0,769294677753,696085765757,475329782306.0,214277768.0,51897787934.0
20200806,734608599055,68894152082,66975774782.0,1918377300.0,37773301613,3878355461,344923057,203550128.0,141372929.0,772381900668,696835297442,521114211584.0,170820499.0,50611708467.0
20200807,729497666990,62547591107,67658523172.0,-5110932065.0,37939285889,3928422375,296214374,246147460.0,50066914.0,767436952879,691558381101,511611229188.0,164921468.0,50063534389.0
20200810,732624432487,63179003993,60052238496.0,3126765497.0,39485819080,4034724855,316805941,210503461.0,106302480.0,772110251567,693138613407,483801672345.0,130858727.0,43931216720.0
20200811,729671717222,56655911478,59608626743.0,-2952715265.0,38831696496,4061661240,295878548,268942163.0,26936385.0,768503413718,690840020726,475697343122.0,148643393.0,39010704877.0
20200812,726584281714,48451850896,51539286404.0,-3087435508.0,38853247680,4064823698,288869294,285706836.0,3162458.0,765437529394,687731034034,439191286104.0,175984513.0,42650074874.0
20200813,726545298137,39514011152,39552994729.0,-38983577.0,39748687723,4141355835,260684847,184152710.0,76532137.0,766293985860,686796610414,350496859863.0,133778017.0,37744082083.0
20200814,723080350545,37650488956,41115436548.0,-3464947592.0,39646308936,4056482332,191773421,276646924.0,-84873503.0,762726659481,683434041609,337539379102.0,98365089.0,30059994954.0
20200817,732081513102,65322276877,56321114320.0,9001162557.0,41418544936,4155128026,311910304,213264610.0,98645694.0,773500058038,690662968166,499789582087.0,188713555.0,38797299159.0
20200818,737139287741,55881433850,50823659211.0,5057774639.0,41334347970,4159733077,236068903,231463852.0,4605051.0,778473635711,695804939771,448019533943.0,151432597.0,45714869388.0
20200819,738102277544,54701448400,53738458597.0,962989803.0,41327647233,4271604287,302792889,190921679.0,111871210.0,779429924777,696774630311,455990416682.0,220952700.0,42903368870.0
20200820,736808467432,37637844019,38931654131.0,-1293810112.0,41088228825,4215268611,203660295,259995971.0,-56335676.0,777896696257,695720238607,370155613989.0,136914969.0,32427866044.0
20200821,735221001471,35992406507,37579872468.0,-1587465961.0,41355164574,4196516379,196118235,214870467.0,-18752232.0,776576166045,693865836897,334367821985.0,128144979.0,27763796356.0
20200824,736231596569,34133645247,33123050149.0,1010595098.0,41586346616,4247176940,238851959,188191398.0,50660561.0,777817943185,694645249953,316267481691.0,313438101.0,29915886661.0
20200825,734610783208,34878351569,36499164930.0,-1620813361.0,41751009607,4273675693,204319692,177820939.0,26498753.0,776361792815,692859773601,329062112399.0,216822648.0,28286252297.0
20200826,731526000698,37360373004,40445155514.0,-3084782510.0,41553249805,4291181688,200605548,183099553.0,17505995.0,773079250503,689972750893,346807054689.0,560582571.0,35184095585.0
20200827,731588258795,31931260230,31869002133.0,62258097.0,42494022394,4283837339,178602321,185946670.0,-7344349.0,774082281189,689094236401,285188283479.0,272596886.0,32616454135.0
20200828,732783678329,40444382927,39248963393.0,1195419534.0,43797383484,4250834482,197958538,230961395.0,-33002857.0,776581061813,688986294845,346199396924.0,376295479.0,34692369630.0
20200831,737496841386,48048396588,43335233531.0,4713163057.0,44296887927,4300591221,236852095,187095356.0,49756739.0,781793729313,693199953459,406396600055.0,303261276.0,31648533657.0
20200901,738562557286,33426894682,32361178782.0,1065715900.0,44685422170,4306130454,156328586,150789353.0,5539233.0,783247979456,693877135116,303442178173.0,216477641.0,24767261539.0
20200902,741383469957,37055853302,34234940631.0,2820912671.0,45765230020,4458269605,274007225,121868074.0,152139151.0,787148699977,695618239937,318845384870.0,210659887.0,28504244279.0
20200903,740658070283,34227945887,34953345561.0,-725399674.0,46865880564,4515155795,213602091,156715901.0,56886190.0,787523950847,693792189719,321751853152.0,199015002.0,31309914950.0
20200904,738886120757,29264357402,31036306928.0,-1771949526.0,46914534374,4477523680,156265206,193897321.0,-37632115.0,785800655131,691971586383,279994611401.0,247269840.0,29665531375.0
20200907,737269953161,34785048598,36401216194.0,-1616167596.0,46381511691,4529672343,209769832,157621169.0,52148663.0,783651464852,690888441470,321901702686.0,218482567.0,36875573989.0
20200908,736096993567,31575477663,32748437257.0,-1172959594.0,47056940490,4534400012,207007555,202279886.0,4727669.0,783153934057,689040053077,294664534258.0,286271968.0,26855363312.0
20200909,733691061340,32530259321,34936191548.0,-2405932227.0,46125019964,4533904621,214270502,214765893.0,-495391.0,779816081304,687566041376,312472907950.0,296199375.0,29508837810.0
20200910,729123226445,26991223005,31559057900.0,-4567834895.0,46304102934,4581892736,218901734,170913619.0,47988115.0,775427329379,682819123511,287499262360.0,161676102.0,23371969415.0
20200911,728111760910,22963813892,23975279427.0,-1011465535.0,46911770982,4580381929,221302978,222813785.0,-1510807.0,775023531892,681199989928,235467606318.0,139298434.0,20571882660.0
20200914,729061180106,22654661047,21705241851.0,949419196.0,48242131887,4684777238,232461282,128065973.0,104395309.0,777303311993,680819048219,245412811858.0,128078455.0,24626550674.0
20200915,729117519444,24342779376,24286440038.0,56339338.0,49556138759,4782943355,243391427,145225310.0,98166117.0,778673658203,679561380685,230068480202.0,99503978.0,22869035625.0
20200916,728439717981,22563293997,23241095460.0,-677801463.0,50209857556,4868840826,224530329,138632858.0,85897471.0,778649575537,678229860425,221955663896.0,126732899.0,20734249766.0
20200917,730029382106,28381120882,26791456757.0,1589664125.0,50969951084,4843073540,187199030,212966316.0,-25767286.0,780999333190,679059431022,245626707209.0,176268412.0,36753768456.0
20200918,731266023818,34946555390,33709913678.0,1236641712.0,53388869210,4933315701,275383881,185141720.0,90242161.0,784654893028,677877154608,308059057242.0,192042241.0,30606334176.0
20200921,730726552552,28407598569,28947069835.0,-539471266.0,53933475742,5005189658,225379158,153505201.0,71873957.0,784660028294,676793076810,262245232764.0,139397905.0,27806188478.0
20200922,731247489707,27538630180,27017693025.0,520937155.0,54686844272,5126546536,288105153,166748275.0,121356878.0,785934333979,676560645435,242753779027.0,97691145.0,27358982352.0
20200923,732305245167,23823816726,22766061266.0,1057755460.0,56265953207,5196001642,227958336,158503230.0,69455106.0,788571198374,676039291960,211349931947.0,67802114.0,31203219532.0
20200924,732858922643,24134224677,23580547201.0,553677476.0,55421493595,5261496389,292556844,227062097.0,65494747.0,788280416238,677437429048,234505143558.0,107521551.0,25003631234.0
20200925,730801783480,20449470754,22506609917.0,-2057139163.0,55177763739,5252695746,216085248,224885891.0,-8800643.0,785979547219,675624019741,202369919876.0,91475841.0,20009652579.0
20200928,728325003590,17978559789,20455339679.0,-2476779890.0,55233077687,5306110930,197549089,144133905.0,53415184.0,783558081277,673091925903,187851323228.0,125102283.0,22815235188.0
20200929,726928420180,19341548887,20738132297.0,-1396583410.0,54931049944,5197381561,159305930,268035299.0,-108729369.0,781859470124,671997370236,187438287852.0,102520708.0,21538184720.0
20200930,718773947637,16674985182,24829457725.0,-8154472543.0,53929546016,5141204785,196923906,253100682.0,-56176776.0,772703493653,664844401621,186222813545.0,101743399.0,20778649033.0
20201009,722623954673,26951364149,23101357113.0,3850007036.0,55633049538,5202217824,145122064,84109025.0,61013039.0,778257004211,666990905135,239838085732.0,165099164.0,24868971640.0
20201012,726418414800,38579671714,34785211587.0,3794460127.0,59129953563,5336988893,262749295,127978226.0,134771069.0,785548368363,667288461237,320867310996.0,253796091.0,35721357248.0
20201013,729474250695,32646696187,29590860292.0,3055835895.0,60173891097,5499055837,318845668,156778724.0,162066944.0,789648141792,669300359598,261422365236.0,173514336.0,27998020834.0
20201014,731954188699,28756960217,26277022213.0,2479938004.0,60819379583,5587155934,249273686,161173589.0,88100097.0,792773568282,671134809116,255963982148.0,268741595.0,25596236120.0
20201015,731454593803,26432417334,26932012230.0,-499594896.0,60972229982,5581038003,207847977,213965908.0,-6117931.0,792426823785,670482363821,238005242703.0,146875567.0,27261269036.0
20201016,730157187663,24408716429,25706122569.0,-1297406140.0,61570839515,5596004600,194965095,179998498.0,14966597.0,791728027178,668586348148,230913215325.0,147530534.0,22673323752.0
20201019,731751610228,29754413853,28159991288.0,1594422565.0,62233207156,5693447096,234477597,137035101.0,97442496.0,793984817384,669518403072,258521795146.0,117316046.0,25717921725.0
20201020,732194798565,22064697825,21621509488.0,443188337.0,63102699867,5743619627,198792980,148620449.0,50172531.0,795297498432,669092098698,206594070009.0,131813637.0,22334632873.0
20201021,732558183793,24190070047,23826684819.0,363385228.0,64349459310,5865226373,229270670,107663924.0,121606746.0,796907643103,668208724483,224000953315.0,109235934.0,23347024559.0
20201022,733209692892,23277229042,22625719943.0,651509099.0,63333461385,5810868587,159131283,213489069.0,-54357786.0,796543154277,669876231507,215334492934.0,90513049.0,21631541880.0
20201023,728885246959,24772322668,29096768601.0,-4324445933.0,62074847684,5780770666,159273021,189370942.0,-30097921.0,790960094643,666810399275,226296549356.0,206696555.0,23951111797.0
20201026,728064512071,24138051819,24958786707.0,-820734888.0,62038648862,5777589612,170994230,174175284.0,-3181054.0,790103160933,666025863209,217528022768.0,146147976.0,18715436770.0
20201027,728401575575,19431592478,19094528974.0,337063504.0,62062133766,5739265071,135122031,173446572.0,-38324541.0,790463709341,666339441809,199064514845.0,108207588.0,19217971272.0
20201028,729233081780,24666448336,23834942131.0,831506205.0,63104614686,5768902174,179565537,149928434.0,29637103.0,792337696466,666128467094,232968815559.0,124364744.0,24463201255.0
20201029,730205468600,27724508747,26752121927.0,972386820.0,64545398802,5839567052,199401002,128736124.0,70664878.0,794750867402,665660069798,253721958121.0,103362105.0,26904300275.0
20201030,726579583483,30622827539,34248712656.0,-3625885117.0,64665330733,5911183017,210974656,139358691.0,71615965.0,791244914216,661914252750,294504683308.0,144816100.0,35516731475.0
20201102,726761818581,29579707654,29397472556.0,182235098.0,65117582278,5932690294,154716405,133209128.0,21507277.0,791879400859,661644236303,297022239266.0,170687949.0,29088512876.0
20201103,728262128568,29691652653,28191342666.0,1500309987.0,66580696143,5967673756,183110099,148126637.0,34983462.0,794842824711,661681432425,275911087845.0,148316483.0,28807966975.0
20201104,729638305309,26653953913,25277777172.0,1376176741.0,67469313599,6030629218,199967943,137012481.0,62955462.0,797107618908,662168991710,247993942971.0,155695743.0,24176237217.0
20201105,731306759721,33074080085,31405625673.0,1668454412.0,68472573064,6034379500,184635128,180884846.0,3750282.0,799779332785,662834186657,289860912142.0,162544113.0,27950458650.0
20201106,730307648470,32974594647,33973705898.0,-999111251.0,68466997485,6041097107,160492040,153774433.0,6717607.0,798774645955,661840650985,299752740882.0,92851796.0,27074913847.0
20201109,736547030957,48348514805,42109132318.0,6239382487.0,70222461104,6039713902,225017082,226400287.0,-1383205.0,806769492061,666324569853,385108504581.0,188287566.0,46143011996.0
20201110,736348759208,39198734903,39397006652.0,-198271749.0,70922451222,6175513417,274565723,138766208.0,135799515.0,807271210430,665426307986,356855875862.0,164134576.0,34068774110.0
20201111,735194222361,35054286792,36208823639.0,-1154536847.0,70388625153,6188943578,167585715,154155554.0,13430161.0,805582847514,664805597208,323749769711.0,242179271.0,32799216384.0
20201112,735155468482,27595611938,27634365817.0,-38753879.0,70750032916,6234857479,171501155,125587254.0,45913901.0,805905501398,664405435566,265142331883.0,246886316.0,23373771363.0
20201113,735796686341,29673116233,29031898374.0,641217859.0,70299741541,6242880951,190274965,182251493.0,8023472.0,806096427882,665496944800,278993260106.0,115623074.0,23856366255.0
20201116,738105266238,32904358627,30595778730.0,2308579897.0,71541892509,6323453584,214655414,134082781.0,80572633.0,809647158747,666563373729,308116109354.0,171096689.0,26527698754.0
20201117,738190820752,35020934966,34935380452.0,85554514.0,72072766835,6406686878,243085720,159852426.0,83233294.0,810263587587,666118053917,328873010701.0,141841137.0,26953625653.0
20201118,738724749306,35748609611,35214681057.0,533928554.0,72556533453,6403230391,238117944,241574431.0,-3456487.0,811281282759,666168215853,332798655021.0,158388325.0,26602066715.0
20201119,737923991149,30378829634,31179587791.0,-800758157.0,72313114235,6356246119,160182965,207167237.0,-46984272.0,810237105384,665610876914,297560512018.0,119443226.0,23202048206.0
20201120,737865462670,31183957732,31242486211.0,-58528479.0,72722586462,6347463941,181484434,190266612.0,-8782178.0,810588049132,665142876208,289832749015.0,117040145.0,23590822409.0
20201123,742675022714,48655916053,43846356009.0,4809560044.0,73972476201,6407149099,258469533,198784375.0,59685158.0,816647498915,668702546513,406650135323.0,198210777.0,25969449841.0
20201124,745084788566,38523407714,36113641862.0,2409765852.0,73675678147,6371381905,171889064,207656258.0,-35767194.0,818760466713,671409110419,332403054387.0,220143222.0,27779033160.0
20201125,746180978294,40713255244,39617065516.0,1096189728.0,72425427362,6391009272,177190530,157563163.0,19627367.0,818606405656,673755550932,357614252675.0,142211334.0,26715113321.0
20201126,744973294987,31358289181,32565972488.0,-1207683307.0,72515479525,6345627322,166886446,212268396.0,-45381950.0,817488774512,672457815462,296682269488.0,120911233.0,21684562502.0
20201127,743489604691,32734883184,34218573480.0,-1483690296.0,73557269829,6365784101,189608178,169451399.0,20156779.0,817046874520,669932334862,306500882540.0,168062768.0,21024500470.0
20201130,747061399190,48767051230,45195256731.0,3571794499.0,73543488297,6397974301,247004396,214814196.0,32190200.0,820604887487,673517910893,430798362251.0,423922135.0,25034482819.0
20201201,749657391509,41657448357,39061456038.0,2595992319.0,74688612595,6330311833,233378474,301040942.0,-67662468.0,824346004104,674968778914,364020270416.0,233604819.0,22349780195.0
20201202,752828422299,40768179703,37597148913.0,3171030790.0,75450814751,6399714984,302559213,233156062.0,69403151.0,828279237050,677377607548,354297521219.0,135846179.0,31547658438.0
20201203,753985375607,37374017034,36217063726.0,1156953308.0,74758649924,6366140449,287462885,321037420.0,-33574535.0,828744025531,679226725683,329718375844.0,90568225.0,25053031714.0
20201204,754258913777,34598642790,34325104620.0,273538170.0,74667979451,6387275794,250712141,229576796.0,21135345.0,828926893228,679590934326,307630294798.0,64752336.0,23632539381.0
20201207,756851607868,34715895237,32123201146.0,2592694091.0,73997349125,6326277875,197128489,258126408.0,-60997919.0,830848956993,682854258743,311216946579.0,99577909.0,27889233057.0
20201208,757976387724,31182662211,30057882355.0,1124779856.0,73727696066,6285979488,206352926,246651313.0,-40298387.0,831704083790,684248691658,282339346715.0,82452847.0,24866720237.0
20201209,754519180325,32383741100,35840948499.0,-3457207399.0,73200119119,6381108117,250337826,155209197.0,95128629.0,827719299444,681319061206,315399658213.0,94947136.0,26075933144.0
20201210,755649047599,31291093912,30161226638.0,1129867274.0,73912195189,6437504460,187002425,130606082.0,56396343.0,829561242788,681736852410,297056640887.0,63870797.0,30296194753.0
20201211,753613864795,33665033981,35700216785.0,-2035182804.0,73211845296,6402915619,197261938,231850779.0,-34588841.0,826825710091,680402019499,344033910455.0,112875943.0,36638030760.0
20201214,755709036504,29444773356,27349601647.0,2095171709.0,74178418405,6430324025,195393978,167985572.0,27408406.0,829887454909,681530618099,291031550227.0,94809608.0,26791223183.0
20201215,756368148234,28577175125,27918063395.0,659111730.0,75117651670,6498944926,252521935,183901034.0,68620901.0,831485799904,681250496564,289412669955.0,72428121.0,27879534215.0
20201216,757250182818,28745028616,27862994032.0,882034584.0,75701406763,6496016293,169900786,172829419.0,-2928633.0,832951589581,681548776055,276106886641.0,59839354.0,33838349809.0
20201217,758568721435,36511166237,35192627620.0,1318538617.0,77518310538,6539696530,237251560,193571323.0,43680237.0,836087031973,681050410897,343152434879.0,92633679.0,29455628130.0
20201218,759171142789,35499760915,34897339561.0,602421354.0,77774434895,6640411495,270689757,169974792.0,100714965.0,836945577684,681396707894,328526905026.0,143843715.0,27368710243.0
20201221,763664230810,41766344322,37273256301.0,4493088021.0,78456815787,6646202307,207242475,201451663.0,5790812.0,842121046597,685207415023,353905683353.0,141094825.0,31078206548.0
20201222,764320464544,45629345481,44973111747.0,656233734.0,77708549565,6766001197,308249025,188450135.0,119798890.0,842029014109,686611914979,402854735669.0,118951518.0,30957118951.0
20201223,766290955690,42346213495,40375722349.0,1970491146.0,78453775600,6747858480,213183482,231326199.0,-18142717.0,844744731290,687837180090,384686445415.0,86956084.0,29957838893.0
20201224,765792112747,37664871207,38163714150.0,-498842943.0,79216193814,6858885402,281000483,169973561.0,111026922.0,845008306561,686575918933,334943775242.0,83747989.0,30175289604.0
20201225,767303833177,39514925337,38003204907.0,1511720430.0,80241447592,6840426533,212627478,231086347.0,-18458869.0,847545280769,687062385585,333742415021.0,93420289.0,26769979220.0
20201228,769227904714,40242435610,38318364073.0,1924071537.0,80589379015,6960948136,293876336,173354733.0,120521603.0,849817283729,688638525699,370657656543.0,106237887.0,28894729618.0
20201229,766565014922,36771234951,39434124743.0,-2662889792.0,80638951944,6977669280,256400655,239679511.0,16721144.0,847203966866,685926062978,358838256692.0,106814410.0,26237774726.0
20201230,768713795726,38017076240,35868295436.0,2148780804.0,83064123526,7056124500,275215318,196760098.0,78455220.0,851777919252,685649672200,346586082871.0,96268820.0,33353168873.0
20201231,768366961044,47044329212,47391163894.0,-346834682.0,85655479796,7242552164,404717525,218289861.0,186427664.0,854022440840,682711481248,415791057541.0,137473697.0,36373480180.0
20210104,780490219310,59792059099,47668800833.0,12123258266.0,85594916893,7333166907,297843212,207228469.0,90614743.0,866085136203,694895302417,484611724350.0,188454485.0,39351387235.0
20210105,786485232814,64068720689,58073707185.0,5995013504.0,85919034933,7400044350,274234682,207357239.0,66877443.0,872404267747,700566197881,532744931948.0,170880640.0,38795717459.0
20210106,789702817707,55516064817,52298479924.0,3217584893.0,87154562339,7474335440,238041357,163750267.0,74291090.0,876857380046,702548255368,486253626437.0,162878633.0,36416031662.0
20210107,792507228848,59965393124,57160981983.0,2804411141.0,89277970861,7551589895,262208935,184954480.0,77254455.0,881785199709,703229257987,505024407225.0,153318198.0,41925818627.0
20210108,792770084113,52918009775,52655154510.0,262855265.0,89862795925,7474415641,228993758,306168012.0,-77174254.0,882632880038,702907288188,467395062626.0,138074827.0,35428051946.0
20210111,793378564093,56336207102,55727727122.0,608479980.0,89464441339,7520064144,255624629,209976126.0,45648503.0,882843005432,703914122754,490427255502.0,115523190.0,37496873736.0
20210112,799390393893,57361406150,51349576350.0,6011829800.0,91746211267,7530545403,325524873,315043614.0,10481259.0,891136605160,707644182626,457288352377.0,127682006.0,29434083377.0
20210113,802444845154,64017454573,60963003312.0,3054451261.0,91225089301,7568477066,265844397,227912734.0,37931663.0,893669934455,711219755853,521161546111.0,155144898.0,33990383212.0
20210114,802748756831,57155041776,56851130099.0,303911677.0,90132664618,7481775857,193248585,279949794.0,-86701209.0,892881421449,712616092213,471382601914.0,151815633.0,40775397386.0
20210115,801616826104,51163771731,52295702458.0,-1131930727.0,89976786638,7433722056,241058265,289112066.0,-48053801.0,891593612742,711640039466,446421989034.0,94537285.0,36401686289.0
20210118,805075741296,49647422370,46188507178.0,3458915192.0,90706543444,7462895649,248088203,218914610.0,29173593.0,895782284740,714369197852,412845926390.0,140760446.0,40388982567.0
20210119,807854268016,51955888008,49177361288.0,2778526720.0,90148843460,7497668717,245938223,211165155.0,34773068.0,898003111476,717705424556,431944376129.0,103985136.0,36221681917.0
20210120,811252474957,44656991305,41258784364.0,3398206941.0,90865328670,7483348034,233236788,247557471.0,-14320683.0,902117803627,720387146287,365996160268.0,161114480.0,31855999211.0
20210121,815992756519,53942981845,49202700283.0,4740281562.0,92320595051,7546963003,263176590,199561621.0,63614969.0,908313351570,723672161468,437329939148.0,136806495.0,33855570319.0
20210122,815403994518,54522258866,55111020867.0,-588762001.0,92052121202,7495142610,171809713,223630106.0,-51820393.0,907456115720,723351873316,445236774039.0,130847661.0,40999915144.0
20210125,819391832231,60567215502,56579377789.0,3987837713.0,92462918141,7539432027,191550594,147261177.0,44289417.0,911854750372,726928914090,484634858307.0,223327003.0,43069626174.0
20210126,816084569630,45345746275,48653008876.0,-3307262601.0,91134644981,7579969244,226620712,186083495.0,40537217.0,907219214611,724949924649,403461362993.0,132455599.0,34104534838.0
20210127,816237694539,40145362869,39992237960.0,153124909.0,90980664752,7590674819,225718852,215013277.0,10705575.0,907218359291,725257029787,366962468642.0,142516621.0,30423157923.0
20210128,814568038845,39663396119,41333051813.0,-1669655694.0,88928321949,7519107173,190077276,261644922.0,-71567646.0,903496360794,725639716896,364276902710.0,136036652.0,28354490216.0
20210129,808530764245,40134151406,46171426006.0,-6037274600.0,87886463615,7418247336,169207629,270067466.0,-100859837.0,896417227860,720644300630,387642760201.0,119093091.0,30859999764.0
20210201,807900109492,33787419612,34418074365.0,-630654753.0,87699520622,7373859344,149203855,193591847.0,-44387992.0,895599630114,720200588870,343942722444.0,162505225.0,28829507630.0
20210202,807418158794,37533872673,38015823371.0,-481950698.0,88303226275,7386440829,230032183,217450698.0,12581485.0,895721385069,719114932519,358112216625.0,142047733.0,27522530850.0
20210203,807189978760,42621756166,42849936200.0,-228180034.0,88548469683,7461530990,251518719,176428558.0,75090161.0,895738448443,718641509077,384202828166.0,117033075.0,30554373938.0
20210204,802902827539,41486860920,45774012141.0,-4287151221.0,87780973049,7395161264,164920794,231290520.0,-66369726.0,890683800588,715121854490,392748779810.0,99727118.0,28111303377.0
20210205,798537947597,39256505179,43621385121.0,-4364879942.0,87230537840,7386121711,169481352,178520905.0,-9039553.0,885768485437,711307409757,372200132326.0,97902375.0,27507681456.0
20210208,796355371775,33386752258,35569328080.0,-2182575822.0,87718590706,7346080807,148374362,188415266.0,-40040904.0,884073962481,708636781069,337828851953.0,110237860.0,23932123339.0
20210209,796972031083,40412055719,39795396411.0,616659308.0,88627326311,7320527938,187447390,213000259.0,-25552869.0,885599357394,708344704772,347677845903.0,138356955.0,26257208435.0
20210210,787516930548,39732264789,49187365324.0,-9455100535.0,87009856851,7154213412,162455427,328769953.0,-166314526.0,874526787399,700507073697,365597066211.0,105291140.0,27921755342.0
20210218,798674299752,57592470219,46435101015.0,11157369204.0,88984489407,7227617856,203012743,129608299.0,73404444.0,887658789159,709689810345,452587779391.0,144721245.0,31241827170.0
20210219,802437603320,54940481670,51177178102.0,3763303568.0,89502507162,7207830734,232925268,252712390.0,-19787122.0,891940110482,712935096158,459134535908.0,232817484.0,26633202809.0
20210222,810360452570,70756180553,62833331303.0,7922849250.0,88421888961,7290337464,266709721,184202991.0,82506730.0,898782341531,721938563609,568254379479.0,423791652.0,31644232775.0
20210223,808409083165,48043375715,49994745120.0,-1951369405.0,89191681408,7321626453,212526735,181237746.0,31288989.0,897600764573,719217401757,456692961985.0,186748282.0,26845123894.0
20210224,809020164487,49327003200,48715921878.0,611081322.0,87837357217,7318389586,232624017,235860884.0,-3236867.0,896857521704,721182807270,456692577626.0,239742106.0,27916336796.0
20210225,809129415626,45910107347,45800856208.0,109251139.0,89122765668,7418394956,241251980,141246610.0,100005370.0,898252181294,720006649958,421102619186.0,255014306.0,25539099775.0
20210226,806306694237,40358250701,43180972090.0,-2822721389.0,86823536945,7405796972,243345852,255943836.0,-12597984.0,893130231182,719483157292,398461395214.0,228559718.0,28001581874.0
20210301,810117759809,39826789094,36015723522.0,3811065572.0,88680489245,7457213895,236994218,185577295.0,51416923.0,898798249054,721437270564,376398120767.0,159397271.0,28259331797.0
20210302,811873629757,42318072306,40562202358.0,1755869948.0,88272256394,7524101377,232314104,165426622.0,66887482.0,900145886151,723601373363,400394985513.0,115778513.0,28396740861.0
20210303,812100512664,39984005981,39757123074.0,226882907.0,90678716817,7580150558,250876757,194827576.0,56049181.0,902779229481,721421795847,389045784339.0,146239402.0,29000260034.0
20210304,809064212364,44587579185,47623879485.0,-3036300300.0,88211554720,7526193504,188622992,242580046.0,-53957054.0,897275767084,720852657644,432877593551.0,169718432.0,30195289130.0
20210305,806221304478,38603742759,41446650645.0,-2842907886.0,87709922023,7453762584,203625497,276056417.0,-72430920.0,893931226501,718511382455,386957246370.0,124297442.0,23246883785.0
20210308,806617415006,43602898883,43206788355.0,396110528.0,85305228863,7483357336,229051556,199456804.0,29594752.0,891922643869,721312186143,425168367008.0,173203530.0,29082337908.0
20210309,802276032864,39315458528,43656840670.0,-4341382142.0,82881970525,7348865006,227694716,362187046.0,-134492330.0,885158003389,719394062339,430623263402.0,142717845.0,26707697143.0
20210310,799146556678,28777814657,31907290843.0,-3129476186.0,83156918867,7328338157,205701918,226228767.0,-20526849.0,882303475545,715989637811,320895172021.0,89572868.0,19659615022.0
20210311,800321367759,35137589573,33962778492.0,1174811081.0,86576219122,7393089908,245527204,180775453.0,64751751.0,886897586881,713745148637,345195997104.0,132631190.0,25325412740.0
20210312,798267706264,35109661371,37163322866.0,-2053661495.0,87829914459,7498087535,294149748,189152121.0,104997627.0,886097620723,710437791805,359879011489.0,128249239.0,22705274809.0
20210315,800532718804,36875911204,34610898664.0,2265012540.0,86432898617,7484507948,225238543,238818130.0,-13579587.0,886965617421,714099820187,361105247809.0,105118117.0,21004161034.0
20210316,798752178835,30250377088,32030917057.0,-1780539969.0,86530061500,7441348577,197217784,240377155.0,-43159371.0,885282240335,712222117335,315289571825.0,109190899.0,17818051570.0
20210317,799559077424,29039426432,28232527843.0,806898589.0,86458609364,7445795673,222388427,217941331.0,4447096.0,886017686788,713100468060,290199281784.0,168106932.0,16991845026.0
20210318,797938882384,29354524810,30974719850.0,-1620195040.0,87290875350,7507061922,282695094,221428845.0,61266249.0,885229757734,710648007034,299864973347.0,86882351.0,18375465084.0
20210319,797113296291,30074027009,30899613102.0,-825586093.0,85648282903,7480780962,273012692,299293652.0,-26280960.0,882761579194,711465013388,321414731504.0,138587351.0,19794545381.0
20210322,799080919527,30745425911,28777802675.0,1967623236.0,87759194104,7512232112,264363700,232912550.0,31451150.0,886840113631,711321725423,315511123334.0,94789894.0,17893415681.0
20210323,797829780590,29564844757,30815983694.0,-1251138937.0,86981766854,7487422329,237432487,262242270.0,-24809783.0,884811547444,710848013736,324728272436.0,89621801.0,19338633618.0
20210324,797166421861,30179125610,30842484339.0,-663358729.0,85689029422,7401302027,244792766,330913068.0,-86120302.0,882855451283,711477392439,326611011830.0,97151324.0,18510102924.0
20210325,794874768272,22927278853,25218932442.0,-2291653589.0,84966938499,7299151954,162249974,264400047.0,-102150073.0,879841706771,709907829773,273287087740.0,80305793.0,17440433103.0
20210326,794126530855,27927807443,28676044860.0,-748237417.0,86560938158,7294689788,261221426,265683592.0,-4462166.0,880687469013,707565592697,304375520432.0,81950353.0,18922474896.0
20210329,795015266755,29267194510,28378458610.0,888735900.0,87581319556,7357259961,281756828,219186655.0,62570173.0,882596586311,707433947199,311776218233.0,86499127.0,18226633233.0
20210330,795773068523,29631171999,28873370231.0,757801768.0,88253543459,7425932537,253282118,184609542.0,68672576.0,884026611982,707519525064,313750332274.0,99806031.0,18246624454.0
20210331,797053733339,28198849972,26918185156.0,1280664816.0,88007216933,7498164752,292380473,220148258.0,72232215.0,885060950272,709046516406,296726169183.0,107744682.0,17926790866.0
20210401,795949098021,27957193285,29061828603.0,-1104635318.0,88803355251,7476144710,216616640,238636682.0,-22020042.0,884752453272,707145742770,271846223888.0,72961617.0,21412676477.0
20210402,794150731478,29811143961,31609510504.0,-1798366543.0,89630523651,7493974245,227113143,209283608.0,17829535.0,883781255129,704520207827,290504002090.0,62088261.0,27985468526.0
20210406,796954365915,28231697364,25428062927.0,2803634437.0,89677613587,7580367217,233615752,147222780.0,86392972.0,886631979502,707276752328,266140305407.0,65666437.0,21288343086.0
20210407,799996518343,29228878414,26186725986.0,3042152428.0,89809555464,7635652295,235411090,180126012.0,55285078.0,889806073807,710186962879,302801492387.0,89407645.0,21162716153.0
20210408,800340627444,31653267123,31309158022.0,344109101.0,90592526566,7701196243,247634346,182090398.0,65543948.0,890933154010,709748100878,325072845148.0,110720133.0,23633451707.0
20210409,799847556152,27075190407,27568261699.0,-493071292.0,90402211447,7691643191,200467970,210021022.0,-9553052.0,890249767599,709445344705,285897890488.0,93500459.0,21335797542.0
20210412,799161820983,28873800028,29559535197.0,-685735169.0,89179217640,7633163131,216936599,275416659.0,-58480060.0,888341038623,709982603343,317864327898.0,89931286.0,21887066806.0
20210413,796009150413,23061667437,26214338007.0,-3152670570.0,89179178184,7643778326,201327453,190712258.0,10615195.0,885188328597,706829972229,273986978263.0,109153728.0,18268418565.0
20210414,796769159448,24228232053,23468223018.0,760009035.0,89208925697,7671085355,222807685,195500656.0,27307029.0,885978085145,707560233751,252696144557.0,87174681.0,18378847646.0
20210415,796817584862,23704746678,23656321264.0,48425414.0,89002051878,7673238419,195096232,192943168.0,2153064.0,885819636740,707815532984,254822832548.0,82685277.0,18467247817.0
20210416,796060470679,25825496200,26582610383.0,-757114183.0,89663300262,7636468277,201254611,238024753.0,-36770142.0,885723770941,706397170417,274246877717.0,109015875.0,22288314395.0
20210419,798163983816,34976133831,32872620694.0,2103513137.0,91633834128,7653729671,187475531,170214137.0,17261394.0,889797817944,706530149688,339146219212.0,158510082.0,29899880591.0
20210420,799379211818,33588880620,32373652618.0,1215228002.0,91811860934,7746820182,246825826,153735315.0,93090511.0,891191072752,707567350884,327618394377.0,143532973.0,32260326766.0
20210421,800209654159,29268825126,28438382785.0,830442341.0,92131021033,7753815238,156717163,149722107.0,6995056.0,892340675192,708078633126,298832401353.0,86939810.0,26601653547.0
20210422,801362797628,29048400797,27895257328.0,1153143469.0,92119814846,7756566493,175409188,172657933.0,2751255.0,893482612474,709242982782,290150833238.0,119901488.0,27330528058.0
20210423,798915127810,29826488858,32274158676.0,-2447669818.0,92409138544,7739507541,159291639,176350591.0,-17058952.0,891324266354,706505989266,296925877515.0,111294170.0,26965279225.0
20210426,800606899865,38417202066,36725430011.0,1691772055.0,92122345346,7754308517,212163864,197362888.0,14800976.0,892729245211,708484554519,351117037072.0,117132354.0,37682118524.0
20210427,799784841520,29825458175,30647516520.0,-822058345.0,91962187850,7759775081,188101387,182634823.0,5466564.0,891747029370,707822653670,299295349271.0,76489499.0,28576203718.0
20210428,801048423429,33983698073,32720116164.0,1263581909.0,92598728863,7775074172,184649551,169350460.0,15299091.0,893647152292,708449694566,317232671604.0,122850319.0,33332068741.0
20210429,799593299537,35635083363,37090207255.0,-1455123892.0,93515387693,7838256130,213091517,149909559.0,63181958.0,893108687230,706077911844,341977352134.0,100559734.0,31475120620.0
20210430,793351750738,36829069449,43070618248.0,-6241548799.0,91993888735,7783077468,141528413,196707075.0,-55178662.0,885345639473,701357862003,366905664110.0,126224712.0,35027602551.0
20210506,797716392311,39783452654,35418811081.0,4364641573.0,91434870430,7766528206,135785794,152335056.0,-16549262.0,889151262741,706281521881,371751444295.0,151732223.0,29641741150.0
20210507,797991832859,40747653569,40472213021.0,275440548.0,91027465952,7797933316,194558469,163153359.0,31405110.0,889019298811,706964366907,383778164138.0,160432310.0,27903844725.0
20210510,801540647009,39763830509,36215016359.0,3548814150.0,91450051268,7833859145,185761984,149836155.0,35925829.0,892990698277,710090595741,375916650477.0,182922043.0,24540966164.0
20210511,802469810548,38332066610,37402903071.0,929163539.0,92247555457,7833575501,174521350,174804994.0,-283644.0,894717366005,710222255091,368750014586.0,155877929.0,22569826556.0
20210512,804277321885,33079658103,31272146766.0,1807511337.0,93106397068,7770063018,167178486,230690969.0,-63512483.0,897383718953,711170924817,320287960632.0,99795317.0,24309895689.0
20210513,805229017067,34527892725,33576197543.0,951695182.0,92218075762,7725117727,155937025,200882316.0,-44945291.0,897447092829,713010941305,332202798080.0,162355309.0,25137184935.0
20210514,804800999074,42976802579,43404820572.0,-428017993.0,94271785076,7732531587,220891175,213477315.0,7413860.0,899072784150,710529213998,385107270404.0,150050626.0,27250558301.0
20210517,807065819160,42543040132,40278220046.0,2264820086.0,95485002123,7697814427,178717801,213434961.0,-34717160.0,902550821283,711580817037,391756428001.0,109712863.0,33698189554.0
20210518,808587241994,35682191958,34160769124.0,1521422834.0,95448344728,7681525209,163407543,179696761.0,-16289218.0,904035586722,713138897266,308150153498.0,92353751.0,28449832611.0
20210519,810481964331,37542704957,35647982620.0,1894722337.0,94558242212,7634436517,164487412,211576104.0,-47088692.0,905040206543,715923722119,320533049757.0,69210747.0,30628496174.0
20210520,811462296683,38063059561,37082727209.0,980332352.0,94363899469,7613394978,166174901,187216440.0,-21041539.0,905826196152,717098397214,359876748386.0,101474478.0,31767643219.0
20210521,810670237086,33088299956,33880359553.0,-792059597.0,93520442395,7583192534,154286777,184489221.0,-30202444.0,904190679481,717149794691,327569985500.0,83733142.0,29992153184.0
20210524,813674545450,35978153268,32973844904.0,3004308364.0,93387489939,7567755725,169827163,185263972.0,-15436809.0,907062035389,720287055511,338940675212.0,104521029.0,29115723884.0
20210525,814261003267,47786319801,47199861984.0,586457817.0,95616627044,7535457991,237353754,269651488.0,-32297734.0,909877630311,718644376223,440180302449.0,102894763.0,33535860895.0
20210526,816490842964,47285027257,45055187560.0,2229839697.0,95582848083,7539786184,197355526,193027333.0,4328193.0,912073691047,720907994881,427125380994.0,106143669.0,31308807873.0
20210527,820729295439,43663317475,39424865000.0,4238452475.0,96271117458,7493772587,161339499,207353096.0,-46013597.0,917000412897,724458177981,390609083418.0,141375984.0,40400065342.0
20210528,821972013714,46937250469,45694532194.0,1242718275.0,96720679933,7612680532,284333949,165426004.0,118907945.0,918692693647,725251333781,408700403318.0,149029967.0,44691357098.0
20210531,827953586295,48051805038,42070232457.0,5981572581.0,97530642986,7591873010,170500778,191308300.0,-20807522.0,925484229281,730422943309,402840210132.0,130426944.0,48162119818.0
20210601,832469753416,48419949351,43903782230.0,4516167121.0,98541793291,7659340565,259064080,191596525.0,67467555.0,931011546707,733927960125,419548106202.0,115743167.0,53372872113.0
20210602,833882640084,44860057103,43447170435.0,1412886668.0,96564019908,7593901758,246432551,311871358.0,-65438807.0,930446659992,737318620176,404288697689.0,177962788.0,51446782556.0
20210603,834774042167,43633522404,42742120321.0,891402083.0,95791782639,7629065437,265582318,230418639.0,35163679.0,930565824806,738982259528,402397620727.0,289772296.0,41511993611.0
20210604,833301157301,41762305697,43235190563.0,-1472884866.0,95827290882,7522505681,207494702,314054458.0,-106559756.0,929128448183,737473866419,397639833744.0,210544694.0,39190323247.0
20210607,837659288066,43242508531,38884377766.0,4358130765.0,96224840497,7533716307,247077433,235866807.0,11210626.0,933884128563,741434447569,390320687533.0,159471905.0,43109356994.0
20210608,838114869374,42617807399,42162226091.0,455581308.0,95352511203,7430227561,177292511,280781257.0,-103488746.0,933467380577,742762358171,400327908010.0,166532050.0,44885573218.0
20210609,838589270926,37514123480,37039721928.0,474401552.0,95181846107,7386547128,172439205,216119638.0,-43680433.0,933771117033,743407424819,364662917179.0,124507017.0,39148947820.0
20210610,840153205978,43091332729,41527397677.0,1563935052.0,96388010833,7397986868,183098741,171659001.0,11439740.0,936541216811,743765195145,399557224011.0,120061444.0,44801724636.0
20210611,837408440042,46654028231,49398794167.0,-2744765936.0,95141038807,7337267756,145957576,206676688.0,-60719112.0,932549478849,742267401235,445727907593.0,92195321.0,50744352239.0
20210615,841056218056,41401213886,37753435872.0,3647778014.0,93632221967,7267949455,142746885,212065186.0,-69318301.0,934688440023,747423996089,399708821057.0,100592018.0,45385214383.0
20210616,839898644373,35873363148,37030936831.0,-1157573683.0,92196146572,7208670717,233355996,292634734.0,-59278738.0,932094790945,747702497801,370155242044.0,113582069.0,40959333845.0
20210617,842780416135,38138621260,35256849498.0,2881771762.0,94043330416,7243839839,260296267,225127145.0,35169122.0,936823746551,748737085719,338949473788.0,109049335.0,50990328914.0
20210618,845059995477,45162874854,42883295512.0,2279579342.0,94182040713,7261768204,293043821,275115456.0,17928365.0,939242036190,750877954764,397457455511.0,156469659.0,49774233986.0
20210621,848131601893,41856642056,38785035640.0,3071606416.0,94074701537,7275259267,227193127,213702064.0,13491063.0,942206303430,754056900356,376095188266.0,118764009.0,51807801533.0
20210622,851273356925,42217943380,39076188348.0,3141755032.0,95872308809,7454536907,409310836,230033196.0,179277640.0,947145665734,755401048116,385025243740.0,124810079.0,52957105130.0
20210623,851813694053,47863196438,47322859310.0,540337128.0,97013206319,7497384756,317732336,274884487.0,42847849.0,948826900372,754800487734,411228040944.0,136708550.0,60727522333.0
20210624,852782054553,42346827777,41378467277.0,968360500.0,96686312451,7584685519,327595571,240294808.0,87300763.0,949468367004,756095742102,409461891603.0,136746801.0,52569041341.0
20210625,852621255199,47328461295,47489260649.0,-160799354.0,98433820758,7614671070,259011599,229026048.0,29985551.0,951055075957,754187434441,434183206514.0,140921970.0,50381344171.0
20210628,858117612067,47922630182,42426273314.0,5496356868.0,98416288080,7599120335,208414321,223965056.0,-15550735.0,956533900147,759701323987,402283102325.0,150278838.0,55427960411.0
20210629,860723220494,42600865590,39995257163.0,2605608427.0,97250925168,7575268718,198127638,221979255.0,-23851617.0,957974145662,763472295326,390374679496.0,137394318.0,51433919451.0
20210630,862822810436,44505649291,42406059349.0,2099589942.0,97989516575,7574604746,208509898,209173870.0,-663972.0,960812327011,764833293861,353325164208.0,117171704.0,61999001096.0
20210701,857176520953,45824988192,51471277675.0,-5646289483.0,98377654813,7682469190,251418825,143554381.0,107864444.0,955554175766,758798866140,392689455463.0,172018618.0,59261455969.0
20210702,856383116685,42976990424,43770394692.0,-793404268.0,95923383838,7554806567,147389749,275052372.0,-127662623.0,952306500523,760459732847,397492943734.0,134118203.0,56552201829.0
20210705,859728229295,43066238704,39721126094.0,3345112610.0,96693294825,7557190745,161344662,158960484.0,2384178.0,956421524120,763034934470,386852973089.0,324528502.0,59149595123.0
20210706,859643243967,47946515849,48031501177.0,-84985328.0,96185914625,7613582528,225599228,169207445.0,56391783.0,955829158592,763457329342,428568009987.0,277050434.0,64852257020.0
20210707,863753184065,48316967173,44207027075.0,4109940098.0,97738107781,7663595177,237484271,187471622.0,50012649.0,961491291846,766015076284,401475392327.0,319511289.0,56793858686.0
20210708,866722341986,55077237551,52108079630.0,2969157921.0,97837012758,7667678475,196001166,191917868.0,4083298.0,964559354744,768885329228,461224894937.0,166982514.0,66340814975.0
20210709,866811908074,48759691637,48670125549.0,89566088.0,97782026131,7642230810,187480769,212928434.0,-25447665.0,964593934205,769029881943,437842365886.0,128545419.0,57259477412.0
20210712,872053294616,60029647754,54788261212.0,5241386542.0,99093982686,7684911308,225759468,183078970.0,42680498.0,971147277302,772959311930,504186232047.0,180180151.0,62209992734.0
20210713,874128252202,52999475374,50924517788.0,2074957586.0,98793660256,7632443941,160922169,213389536.0,-52467367.0,972921912458,775334591946,453797941821.0,228815103.0,59175425289.0
20210714,872899264566,49127695555,50356683191.0,-1228987636.0,96898381507,7602801357,188136996,217779580.0,-29642584.0,969797646073,776000883059,459673250460.0,165709756.0,49955339002.0
20210715,872344914304,49569635475,50123985737.0,-554350262.0,97754617076,7623805567,249340621,228336411.0,21004210.0,970099531380,774590297228,457854073439.0,187004390.0,51450853265.0
20210716,871247201089,54210169393,55307882608.0,-1097713215.0,96779729001,7637373133,205342646,191775080.0,13567566.0,968026930090,774467472088,467896689776.0,217368950.0,52625323664.0
20210719,872204634809,47652085060,46694651340.0,957433720.0,95819794833,7614943150,186814534,209244517.0,-22429983.0,968024429642,776384839976,441114012816.0,186060323.0,47052845043.0
20210720,872574217435,39771819830,39402237204.0,369582626.0,95771947704,7578597733,154650329,190995746.0,-36345417.0,968346165139,776802269731,382131470561.0,146771929.0,43178441414.0
20210721,876263677708,56322486216,52633025943.0,3689460273.0,96723158455,7612193302,195989058,162393489.0,33595569.0,972986836163,779540519253,464918594096.0,141496770.0,53818682896.0
20210722,881145142633,60847410671,55965945746.0,4881464925.0,98110496208,7667577789,213883534,158499047.0,55384487.0,979255638841,783034646425,494105012200.0,99251666.0,74525642300.0
20210723,881396553942,64333614411,64082203102.0,251411309.0,97519995976,7712000053,233540705,189118441.0,44422264.0,978916549918,783876557966,537846602069.0,110117798.0,67211350923.0
20210726,884072314143,66240315749,63564555548.0,2675760201.0,95893696994,7681352956,196868693,227515790.0,-30647097.0,979966011137,788178617149,565476047288.0,210616318.0,74409139048.0
20210727,881974200598,71454914962,73553028507.0,-2098113545.0,94275342063,7630322539,213227696,264258113.0,-51030417.0,976249542661,787698858535,602313775112.0,263123619.0,101820755983.0
20210728,875017626385,48356000041,55312574254.0,-6956574213.0,93589940718,7631125526,233371172,232568185.0,802987.0,968607567103,781427685667,492869910125.0,231492760.0,73339255924.0
20210729,877935876728,54235311628,51317061285.0,2918250343.0,96359375974,7698184456,293419711,226360781.0,67058930.0,974295252702,781576500754,464541407164.0,180134032.0,77568866367.0
20210730,875692505732,54021721651,56265092647.0,-2243370996.0,96449617205,7702378905,244606875,240412426.0,4194449.0,972142122937,779242888527,486569356951.0,152852814.0,84536157794.0
20210802,880443503451,68516927730,63765930011.0,4750997719.0,98413628446,7859272769,397380210,240486346.0,156893864.0,978857131897,782029875005,575065990432.0,142713908.0,85293639952.0
20210803,879217994964,57995438660,59220947147.0,-1225508487.0,97463262183,7813160708,339154043,385266104.0,-46112061.0,976681257147,781754732781,523250134391.0,139349537.0,81007331765.0
20210804,881972881172,56117682644,53362796436.0,2754886208.0,99568232422,7907422697,294717070,200455081.0,94261989.0,981541113594,782404648750,474831109213.0,140053506.0,74706837512.0
20210805,882804292001,54638374264,53806963435.0,831410829.0,100122802739,8006536154,319642645,220529188.0,99113457.0,982927094740,782681489262,465241078177.0,117176101.0,76621536894.0
20210806,884172429529,53337436391,51969298863.0,1368137528.0,100149418320,8003081634,225081253,228535773.0,-3454520.0,984321847849,784023011209,440854427346.0,114341564.0,76425220369.0
20210809,887076996399,54715347711,51810780841.0,2904566870.0,100382674700,8010161696,290011638,282931576.0,7080062.0,987459671099,786694321699,476348888693.0,143021080.0,65686244190.0
20210810,887179157175,52545175434,52443014658.0,102160776.0,101170598664,8026491785,255515009,239184920.0,16330089.0,988349755839,786008558511,488547165954.0,175008461.0,67009368120.0
20210811,889399169595,53852472884,51632460464.0,2220012420.0,101808014682,8184424887,357816435,199883333.0,157933102.0,991207184277,787591154913,475955919586.0,196025018.0,66845711070.0
20210812,893309284237,55756608511,51846493869.0,3910114642.0,102560567635,8190920190,248548010,242052707.0,6495303.0,995869851872,790748716602,472854294589.0,160506159.0,66829001495.0
20210813,891183785513,53515465795,55640964519.0,-2125498724.0,101897097267,8194218038,215300631,212002783.0,3297848.0,993080882780,789286688246,465628274048.0,178405094.0,69131856985.0
20210816,890815556382,51451588746,51819817877.0,-368229131.0,101704194792,8180481491,239666561,253403108.0,-13736547.0,992519751174,789111361590,469938276939.0,174794540.0,66036271892.0
20210817,885923828822,53096929565,57988657125.0,-4891727560.0,98996714339,8135895799,267796168,312381860.0,-44585692.0,984920543161,786927114483,512287083877.0,206292707.0,58539731155.0
20210818,887500266893,53111294208,51534856137.0,1576438071.0,101079206938,8172352671,324023464,287566592.0,36456872.0,988579473831,786421059955,483044108208.0,143349087.0,54922319895.0
20210819,884683739098,51429984562,54246512357.0,-2816527795.0,101508510619,8250185771,332956016,255122916.0,77833100.0,986192249717,783175228479,482677520457.0,173114788.0,56314996352.0
20210820,882309838568,49629607117,52003507647.0,-2373900530.0,100256058076,8211197721,244483963,283472013.0,-38988050.0,982565896644,782053780492,496519191671.0,185958218.0,57626659673.0
20210823,890417780550,59821872994,51713931012.0,8107941982.0,102556909435,8342383142,371511949,240326528.0,131185421.0,992974689985,787860871115,497542485854.0,148273641.0,68195260492.0
20210824,893429651301,64950589822,61938719071.0,3011870751.0,103911933129,8308655028,305646808,339374922.0,-33728114.0,997341584430,789517718172,547306870233.0,181661471.0,70240016592.0
20210825,895334183375,59483131832,57578599758.0,1904532074.0,104461948415,8367973218,297335095,238016905.0,59318190.0,999796131790,790872234960,531906193372.0,139793129.0,68020191155.0
20210826,898406898219,64515650603,61442935759.0,3072714844.0,102531436626,8406372915,304988634,266588937.0,38399697.0,1000938334845,795875461593,556877658801.0,166368393.0,66940042432.0
20210827,894912847257,57941035122,61435086084.0,-3494050962.0,103216094853,8369892377,271881085,308361623.0,-36480538.0,998128942110,791696752404,539133396937.0,120572229.0,58781752574.0
20210830,899089666980,71793951316,67617131593.0,4176819723.0,102812042868,8360167492,245771889,255496774.0,-9724885.0,1001901709848,796277624112,630475736380.0,278406113.0,70397729709.0
20210831,899385982475,69614291662,69317976167.0,296315495.0,103419407592,8423755945,333742485,270154032.0,63588453.0,1002805390067,795966574883,642062157221.0,247453176.0,62442979705.0
20210901,901344977545,86597069009,84638073939.0,1958995070.0,103663834893,8387209427,297521935,334068453.0,-36546518.0,1005008812438,797681142652,780733640744.0,288409166.0,62451641695.0
20210902,902656833418,70371946215,69060090342.0,1311855873.0,104774234814,8429825646,313886617,271270398.0,42616219.0,1007431068232,797882598604,639168958602.0,229744728.0,53505175418.0
20210903,900676269106,75719281139,77699845451.0,-1980564312.0,104758890713,8430280122,296836888,296382412.0,454476.0,1005435159819,795917378393,690075461416.0,218940140.0,54641586693.0
20210906,906099410796,66674031592,61250889902.0,5423141690.0,106286080856,8481850742,319750891,268180271.0,51570620.0,1012385491652,799813329940,604171352094.0,195452041.0,50851343484.0
20210907,910090394094,70057212943,66066229645.0,3990983298.0,108236745391,8540317146,348717096,290250692.0,58466404.0,1018327139485,801853648703,609234639455.0,270330368.0,51924036219.0
20210908,916346887959,71760709336,65504215471.0,6256493865.0,107164175566,8520802344,274574331,294089133.0,-19514802.0,1023511063525,809182712393,626276341073.0,296470275.0,50437531772.0
20210909,922785428017,71655913658,65217373600.0,6438540058.0,107211525130,8573933777,297802445,244671012.0,53131433.0,1029996953147,815573902887,632913727366.0,235824456.0,47125993892.0
20210910,923583113669,80842562738,80044877086.0,797685652.0,108416022741,8573759510,308362893,308537160.0,-174267.0,1031999136410,815167090928,705474776718.0,238605177.0,56121494128.0
20210913,930764129760,74688081068,67507064977.0,7181016091.0,108239179285,8630741888,298055524,241073146.0,56982378.0,1039003309045,822524950475,646258796089.0,273867591.0,51385170781.0
20210914,931887499426,64458724366,63335354700.0,1123369666.0,106757605514,8610372674,251012665,271381879.0,-20369214.0,1038645104940,825129893912,643188511557.0,250421826.0,51911299154.0
20210915,933956191047,59579067963,57510376342.0,2068691621.0,105045833373,8524306698,191118285,277184261.0,-86065976.0,1039002024420,828910357674,562563074181.0,196230537.0,43744271973.0
20210916,928450655117,62812468076,68318004006.0,-5505535930.0,103023440954,8519943804,259896297,264259191.0,-4362894.0,1031474096071,825427214163,627022038652.0,259360530.0,48227024192.0
20210917,918229550357,56799118824,67020223584.0,-10221104760.0,101569628292,8434497906,308884909,394330807.0,-85445898.0,1019799178649,816659922065,583496773547.0,248154176.0,46407127798.0
20210922,922535888976,55066782639,50760444020.0,4306338619.0,102145956992,8460713582,232047759,205832083.0,26215676.0,1024681845968,820389931984,521295046685.0,231773363.0,41103330756.0
20210923,926721903101,60521358820,56335344695.0,4186014125.0,103357515443,8553340629,304160389,211533342.0,92627047.0,1030079418544,823364387658,596252937711.0,257784911.0,38680369236.0
20210924,921279018246,52299976833,57742861688.0,-5442884855.0,102690600224,8577353424,274008897,249996102.0,24012795.0,1023969618470,818588418022,568781157347.0,259607510.0,39860681708.0
20210927,914364873491,55209063606,62123208361.0,-6914144755.0,100943333095,8594295559,282728397,265786262.0,16942135.0,1015308206586,813421540396,598044732100.0,292965490.0,44311679008.0
20210928,912997702505,40684816167,42051987153.0,-1367170986.0,101217004259,8623096503,253054200,224253256.0,28800944.0,1014214706764,811780698246,468985943870.0,192569394.0,32967118657.0
20210929,906996167002,41078137304,47079672807.0,-6001535503.0,98621341782,8522245819,227865806,328716490.0,-100850684.0,1005617508784,808374825220,476218065218.0,200075164.0,36101273449.0
20210930,896254829811,34050236728,44791573919.0,-10741337191.0,97797889923,8383890718,140868063,279223164.0,-138355101.0,994052719734,798456939888,414211758772.0,148445628.0,32033188522.0
20211008,901386226189,43814526350,38683129972.0,5131396378.0,98809444804,8450600284,192141641,125432075.0,66709566.0,1000195670993,802576781385,461153735449.0,246528385.0,31710020438.0
20211011,902622940053,39312230297,38075516433.0,1236713864.0,99137683894,8510107992,235607206,176099498.0,59507708.0,1001760623947,803485256159,437753296148.0,233980211.0,31490250347.0
20211012,900741231360,37906014955,39787723648.0,-1881708693.0,98092384334,8620578439,305462215,194991768.0,110470447.0,998833615694,802648847026,428904280539.0,246106426.0,33232367511.0
20211013,898870170634,34878678284,36749739010.0,-1871060726.0,99443662266,8660660856,213077783,172995366.0,40082417.0,998313832900,799426508368,374218853544.0,201836442.0,31244523148.0
20211014,898738267985,33001218091,33133120740.0,-131902649.0,100024800121,8731566637,211470420,140564639.0,70905781.0,998763068106,798713467864,347923744374.0,146162381.0,31357388414.0
20211015,895814114221,33925573306,36849727070.0,-2924153764.0,101117724592,8774160431,203783469,161189675.0,42593794.0,996931838813,794696389629,388024459013.0,147755469.0,38499019802.0
20211018,901100271885,41038828992,35752671328.0,5286157664.0,101018597121,8815899764,193940880,152201547.0,41739333.0,1002118869006,800081674764,418086080496.0,171070646.0,39117825399.0
20211019,902716530777,38149744526,36533485634.0,1616258892.0,101979877014,8865935647,233048482,183012599.0,50035883.0,1004696407791,800736653763,404762340196.0,176827256.0,36054694706.0
20211020,905782630328,41278425865,38212326314.0,3066099551.0,102318301335,8899072679,202952676,169815644.0,33137032.0,1008100931663,803464328993,411273413828.0,311053550.0,40239127332.0
20211021,906155333844,40350578074,39977874558.0,372703516.0,101855206036,8896570924,210896836,213398591.0,-2501755.0,1008010539880,804300127808,418642869435.0,163672580.0,35580001679.0
20211022,903152283548,37616194601,40619244897.0,-3003050296.0,101302784274,8874439563,193849281,215980642.0,-22131361.0,1004455067822,801849499274,417648179461.0,167658154.0,38030766473.0
20211025,905911108778,39970769027,37211943797.0,2758825230.0,102003833773,8888564422,223734747,209609888.0,14124859.0,1007914942551,803907275005,403400292386.0,147570759.0,42343442366.0
20211026,908601388757,41992255878,39301975899.0,2690279979.0,101528305116,8903806080,249715837,234474179.0,15241658.0,1010129693873,807073083641,419028186999.0,137441185.0,47093899174.0
20211027,910663397709,42423046786,40361037834.0,2062008952.0,99452559483,8873074524,207620657,238352213.0,-30731556.0,1010115957192,811210838226,425058918404.0,182319130.0,46504078965.0
20211028,906812813649,41100174730,44950758790.0,-3850584060.0,95344964238,8660369379,203595181,416300326.0,-212705145.0,1002157777887,811467849411,456722010309.0,336484532.0,47621821919.0
20211029,903863548830,43520693551,46469958370.0,-2949264819.0,94180423183,8522639342,205134822,342864859.0,-137730037.0,998043972013,809683125647,477221146043.0,165428427.0,51651725099.0
20211101,904908107430,46606105277,45561546677.0,1044558600.0,93989314278,8496606040,200522082,226555384.0,-26033302.0,998897421708,810918793152,509737219659.0,211408557.0,55671232820.0
20211102,902216238930,48420329736,51112198236.0,-2691868500.0,92685102054,8472205265,267184479,291585254.0,-24400775.0,994901340984,809531136876,531287603207.0,231412077.0,55691911069.0
20211103,900087292307,34982691989,37111638612.0,-2128946623.0,91816672291,8393896623,200769071,279077713.0,-78308642.0,991903964598,808270620016,407583816030.0,149637200.0,43379410332.0
20211104,902439884671,40931845606,38579253242.0,2352592364.0,91306599468,8291073849,196519508,299342282.0,-102822774.0,993746484139,811133285203,425333480414.0,170180759.0,47177806065.0
20211105,895795759951,39102989555,45747114275.0,-6644124720.0,89713336499,8182178329,194202979,303098499.0,-108895520.0,985509096450,806082423452,439329320574.0,306255373.0,48708829521.0
20211108,896875925401,34657377284,33577211834.0,1080165450.0,88505142150,8021072954,188996318,350101693.0,-161105375.0,985381067551,808370783251,376704475598.0,148309413.0,45716618539.0
20211109,898707817919,36197603337,34365710819.0,1831892518.0,88399996368,7984987066,236304227,272390115.0,-36085888.0,987107814287,810307821551,374555247901.0,141915912.0,48810439453.0
20211110,899331842771,38213740740,37589715888.0,624024852.0,88283798030,7976232002,254662884,263417948.0,-8755064.0,987615640801,811048044741,395542795152.0,192772997.0,49388751235.0
20211111,899651946243,40845453722,40525350250.0,320103472.0,88945920482,8001363295,231769188,206637895.0,25131293.0,988597866725,810706025761,409984585198.0,231744558.0,57776296609.0
20211112,896986190333,37409750345,40075506255.0,-2665755910.0,88357465487,7958398713,183178633,226143215.0,-42964582.0,985343655820,808628724846,386014118383.0,194706341.0,59322731155.0
20211115,897001566079,38014892449,37999516703.0,15375746.0,86771474996,7913583404,194971076,239786385.0,-44815309.0,983773041075,810230091083,402912446898.0,131908891.0,62049996657.0
20211116,895203793301,35725653903,37523426681.0,-1797772778.0,85833109101,7946830244,231808384,198561544.0,33246840.0,981036902402,809370684200,392738971400.0,157203703.0,52930113874.0
20211117,896710208816,33042433944,31536018429.0,1506415515.0,85331457592,7855128385,174135656,265837515.0,-91701859.0,982041666408,811378751224,352591815049.0,205326334.0,52011492595.0
20211118,897810789912,36889117611,35788536515.0,1100581096.0,84617589176,7839348849,234463923,250243459.0,-15779536.0,982428379088,813193200736,377391389343.0,149182996.0,59154198346.0
20211119,896957362621,37705003805,38558431096.0,-853427291.0,85085143521,7832746754,236196959,242799054.0,-6602095.0,982042506142,811872219100,390562131489.0,207555351.0,53689648222.0
20211122,902371955149,46186133754,40771541226.0,5414592528.0,84978454593,7772729201,245997975,306015528.0,-60017553.0,987350409742,817393500556,443510641572.0,401054460.0,68395402581.0
20211123,904116936824,45229945425,43484963750.0,1744981675.0,84311209210,7786592760,259601860,245738301.0,13863559.0,988428146034,819805727614,446084250942.0,252778511.0,63206319009.0
20211124,904574071421,42353285513,41896150916.0,457134597.0,83526135212,7787465420,252782557,251909897.0,872660.0,988100206633,821047936209,422119512807.0,178357126.0,60307847392.0
20211125,905679295346,39546784309,38441560384.0,1105223925.0,83150510946,7789060637,184601581,183006364.0,1595217.0,988829806292,822528784400,395784165189.0,217491116.0,56240574661.0
20211126,904436858616,37193288982,38435725712.0,-1242436730.0,82756122106,7755927342,176626664,209759959.0,-33133295.0,987192980722,821680736510,380341984046.0,269265270.0,57472126311.0
20211129,906873810702,41921659792,39484707706.0,2436952086.0,82853907417,7716317763,219058017,258667596.0,-39609579.0,989727718119,824019903285,424496101436.0,215261345.0,66657180051.0
20211130,908483085484,40994523589,39385248807.0,1609274782.0,82042756602,7670747313,216958336,262528786.0,-45570450.0,990525842086,826440328882,431163396505.0,1319879443.0,62175802648.0
20211201,910308466514,38128286098,36302905068.0,1825381030.0,81073668514,7604603826,215337014,281480501.0,-66143487.0,991382135028,829234798000,410801608089.0,276250050.0,58229019141.0
20211202,908489878210,38409376235,40227964539.0,-1818588304.0,78118238432,7424060581,222146964,402690209.0,-180543245.0,986608116642,830371639778,416167824128.0,225799328.0,53484146847.0
20211203,907443980718,41216130997,42262028489.0,-1045897492.0,78650822945,7483428616,313523901,254155866.0,59368035.0,986094803663,828793157773,445721921918.0,259581739.0,49538166629.0
20211206,907463353414,45490504601,45471131905.0,19372696.0,77826059128,7541633270,274109768,215905114.0,58204654.0,985289412542,829637294286,475518322751.0,292336068.0,53092561207.0
20211207,906117771051,43135827601,44481409964.0,-1345582363.0,77132981263,7531357204,249054975,259331041.0,-10276066.0,983250752314,828984789788,476891913314.0,169036254.0,50060537884.0
20211208,907881320453,42276318790,40512769388.0,1763549402.0,78143700115,7568010727,248789101,212135578.0,36653523.0,986025020568,829737620338,444166266201.0,153724612.0,43995169433.0
20211209,908880092802,49857018620,48858246271.0,998772349.0,78400671615,7567207405,229122615,229925937.0,-803322.0,987280764417,830479421187,520105581041.0,141188116.0,51658782465.0
20211210,910033221248,43886035015,42732906569.0,1153128446.0,77680483273,7500910611,186412928,252709722.0,-66296794.0,987713704521,832352737975,491814787632.0,136667231.0,65522843644.0
20211213,913950078858,48895575668,44978718058.0,3916857610.0,77804138164,7499629807,212546575,213827379.0,-1280804.0,991754217022,836145940694,522439958851.0,152805777.0,53132188129.0
20211214,915338431382,41167413592,39779061068.0,1388352524.0,77021710188,7482782843,218304535,235151499.0,-16846964.0,992360141570,838316721194,441407929072.0,170064837.0,47367801491.0
20211215,917286307636,41489543228,39541666974.0,1947876254.0,76384758167,7480900638,278816931,280699136.0,-1882205.0,993671065803,840901549469,429051558652.0,115426992.0,53545900471.0
20211216,916542583380,39615692249,40359416505.0,-743724256.0,76418145995,7498260351,272698227,255338514.0,17359713.0,992960729375,840124437385,421094371647.0,189591554.0,46265619731.0
20211217,912380095462,40249533352,44412021270.0,-4162487918.0,75503822107,7516205481,257418358,239473228.0,17945130.0,987883917569,836876273355,445779273105.0,280306018.0,48390689931.0
20211220,911283958963,36475815857,37571952356.0,-1096136499.0,74383433532,7485124045,237192776,268274212.0,-31081436.0,985667392495,836900525431,443034725269.0,182140905.0,49950331275.0
20211221,910211617764,34206403936,35278745135.0,-1072341199.0,74784920407,7499951051,288124157,273297151.0,14827006.0,984996538171,835426697357,390400012742.0,166361302.0,40196265883.0
20211222,910705749396,34969631563,34475499931.0,494131632.0,74995953775,7518737988,250088416,231301479.0,18786937.0,985701703171,835709795621,394866729134.0,147384654.0,41681045531.0
20211223,910955003301,37489306028,37240052123.0,249253905.0,75917503766,7613599765,283256915,188395138.0,94861777.0,986872507067,835037499535,412081842971.0,110582526.0,39628611289.0
20211224,905742911873,40269156117,45481247545.0,-5212091428.0,75488891458,7670593709,265029679,208035735.0,56993944.0,981231803331,830254020415,434235340139.0,132080528.0,44193146269.0
20211227,907936630520,34462816755,32269098108.0,2193718647.0,74946640037,7639180627,246929691,278342773.0,-31413082.0,982883270557,832989990483,371366000000.0,136000000.0,37823000000.0
20211228,909665874508,33059173489,31329929501.0,1729243988.0,75093237297,7557685688,257517318,339012257.0,-81494939.0,984759111805,834572637211,371889000000.0,127000000.0,39399000000.0
20211229,908622510506,32634308832,33677672834.0,-1043364002.0,74743594125,7616064858,328403102,270023932.0,58379170.0,983366104631,833878916381,377306000000.0,112000000.0,37340000000.0
20211230,908562701859,34730627768,34790436415.0,-59808647.0,76855862617,7777311639,415320812,254074031.0,161246781.0,985418564476,831706839242,371864000000.0,84000000.0,45579000000.0
20211231,903074844982,35086122406,40573979283.0,-5487856877.0,77526443094,7856597209,324024197,244738627.0,79285570.0,980601288076,825548401888,387345000000.0,134000000.0,46853000000.0
20220104,906057651977,43225523638,40242716643.0,2982806995.0,73986984743,7425000720,212529992,644126481.0,-431596489.0,980044636720,832070667234,457235000000.0,163000000.0,53656000000.0
20220105,904167215798,41441867406,43332303585.0,-1890436179.0,72172661033,7374898946,239561597,289663371.0,-50101774.0,976339876831,831994554765,488291000000.0,167000000.0,51487000000.0
20220106,904082746979,35147602767,35232071586.0,-84468819.0,72154331847,7398899422,247773025,223772549.0,24000476.0,976237078826,831928415132,429387000000.0,159000000.0,46199000000.0
20220107,895813442330,37040847589,45310152238.0,-8269304649.0,71268730282,7347023572,197057658,248933508.0,-51875850.0,967082172612,824544712048,455428000000.0,116000000.0,48275000000.0
20220110,896873723408,33991345816,32931064738.0,1060281078.0,71151294063,7351682503,236847633,232188702.0,4658931.0,968025017471,825722429345,395110000000.0,127000000.0,49849000000.0
20220111,896737126432,34470087686,34606684662.0,-136596976.0,70433794659,7381310239,238267567,208639831.0,29627736.0,967170921091,826303331773,393300000000.0,126000000.0,49001000000.0
20220112,898405575020,34954508284,33286059696.0,1668448588.0,70938053988,7379376625,256655035,258588649.0,-1933614.0,969343629008,827467521032,381837000000.0,127000000.0,55348000000.0
20220113,897215444391,35756831126,36946961755.0,-1190130629.0,69762671602,7307329256,208731780,280779149.0,-72047369.0,966978115993,827452772789,405855000000.0,118000000.0,52026000000.0
20220114,895539506386,37429274986,39105212991.0,-1675938005.0,69193804514,7213149205,198865887,293045938.0,-94180051.0,964733310900,826345701872,402849000000.0,83000000.0,61116000000.0
20220117,896735334253,35910564085,34714736218.0,1195827867.0,69711053098,7181925055,218382833,249606983.0,-31224150.0,966446387351,827024281155,371546000000.0,180000000.0,67446000000.0
20220118,895190092705,37925439622,39470681170.0,-1545241548.0,69781414468,7204032282,280363582,258256355.0,22107227.0,964971507173,825408678237,409030000000.0,85000000.0,63341000000.0
20220119,892008945432,31365456127,34546603400.0,-3181147273.0,68403399190,7137349632,225656834,292339484.0,-66682650.0,960412344622,823605546242,372477000000.0,96000000.0,49029000000.0
20220120,886686826861,35407631063,40729749634.0,-5322118571.0,67834549214,7150618551,297200548,283931629.0,13268919.0,954521376075,818852277647,411181000000.0,75000000.0,49705000000.0
20220121,881353735363,31160145530,36493237028.0,-5333091498.0,66795846737,7113806329,229791508,266603730.0,-36812222.0,948149582100,814557888626,374143000000.0,124000000.0,46343000000.0
20220124,879433636370,26403922588,28324021581.0,-1920098993.0,65372745895,6967230248,205496472,352072553.0,-146576081.0,944806382265,814060890475,317059000000.0,99000000.0,41888000000.0
20220125,875761757447,30148004614,33819883537.0,-3671878923.0,62815257517,6883328915,238690735,322592068.0,-83901333.0,938577014964,812946499930,342277000000.0,195000000.0,42200000000.0
20220126,872693075234,23898167033,26966849246.0,-3068682213.0,63184486286,6885648236,320615634,318296313.0,2319321.0,935877561520,809508588948,294701000000.0,89000000.0,43987000000.0
20220127,868250393955,24620243523,29062924802.0,-4442681279.0,60473114561,6785459506,241068704,341257434.0,-100188730.0,928723508516,807777279394,305460000000.0,107000000.0,42490000000.0
20220128,854740314467,23132952667,36643032155.0,-13510079488.0,59174427770,6688387295,233346885,330419096.0,-97072211.0,913914742237,795565886697,316927000000.0,192000000.0,37430000000.0
20220207,855901800819,27310266202,26148779850.0,1161486352.0,60215503155,6791621128,305413640,202179807.0,103233833.0,916117303974,795686297664,323528000000.0,144000000.0,33982000000.0
20220208,854484927188,29090527058,30507400689.0,-1416873631.0,61059264042,6839315202,351533250,303839176.0,47694074.0,915544191230,793425663146,353120000000.0,171000000.0,35128000000.0
20220209,854850368933,30336916681,29971474936.0,365441745.0,62437858058,6838008023,267397642,268704821.0,-1307179.0,917288226991,792412510875,358735000000.0,163000000.0,36731000000.0
20220210,853570690387,29621852856,30901531402.0,-1279678546.0,62421930804,6798387705,284336216,323956534.0,-39620318.0,915992621191,791148759583,365439000000.0,118000000.0,41000000000.0
20220211,849788559074,30934333775,34716465088.0,-3782131313.0,61938605900,6780239975,243821637,261969367.0,-18147730.0,911727164974,787849953174,388718000000.0,151000000.0,37903000000.0
20220214,852506500811,28602302085,25884360348.0,2717941737.0,60968329760,6724149913,214567154,270657216.0,-56090062.0,913474830571,791538171051,333804000000.0,167000000.0,29119000000.0
20220215,853614767892,25909466346,24801199265.0,1108267081.0,61947518943,6725968120,262927556,261109349.0,1818207.0,915562286835,791667248949,307270000000.0,120000000.0,34725000000.0
20220216,853461937896,24734170700,24887000696.0,-152829996.0,62289200189,6764039244,266509212,228438088.0,38071124.0,915751138085,791172737707,293620000000.0,94000000.0,32283000000.0
20220217,853470424387,28464686653,28456200162.0,8486491.0,62545298411,6817210351,301424906,248253799.0,53171107.0,916015722798,790925125976,322047000000.0,98000000.0,34327000000.0
20220218,851255690984,25778155366,27992888769.0,-2214733403.0,62368337142,6770550852,245162157,291821656.0,-46659499.0,913624028126,788887353842,297591000000.0,150000000.0,30051000000.0
20220221,854404344357,30163407887,27014754514.0,3148653373.0,62246614874,6743228054,250001572,277324370.0,-27322798.0,916650959231,792157729483,312748000000.0,202000000.0,33069000000.0
20220222,856149573287,33426558686,31681329756.0,1745228930.0,61458973035,6755461901,309415297,297181450.0,12233847.0,917608546322,794690600252,353473000000.0,200000000.0,35053000000.0
20220223,859158753274,36391242811,33382062824.0,3009179987.0,62758341598,6761764661,322733315,316430555.0,6302760.0,921917094872,796400411676,371127000000.0,157000000.0,46117000000.0
20220224,859170791373,48897327108,48885289009.0,12038099.0,61590156396,6736030040,387100408,412835029.0,-25734621.0,920760947769,797580634977,519155000000.0,215000000.0,51448000000.0
20220225,857890092841,36054568394,37335266926.0,-1280698532.0,61561853385,6694818276,319754816,360966580.0,-41211764.0,919451946226,796328239456,396472000000.0,193000000.0,46406000000.0
20220228,858010482942,32685307599,32564917498.0,120390101.0,62044753873,6647605888,303879192,351091580.0,-47212388.0,920055236815,795965729069,364510000000.0,237000000.0,50504000000.0
20220301,858304931586,34534560384,34240111740.0,294448644.0,63055096244,6758944437,354385418,243046869.0,111338549.0,921360027830,795249835342,370923000000.0,297000000.0,42770000000.0
20220302,859052842301,31820705317,31072794602.0,747910715.0,62964589847,6822172437,331524263,268296263.0,63228000.0,922017432148,796088252454,344250000000.0,252000000.0,36457000000.0
20220303,858343094456,36976863382,37686611227.0,-709747845.0,62867627397,6833314785,302981712,291839364.0,11142348.0,921210721853,795475467059,404921000000.0,131000000.0,39660000000.0
20220304,856218564496,33748990174,35873520134.0,-2124529960.0,61847334343,6744721747,289918372,378511410.0,-88593038.0,918065898839,794371230153,391384000000.0,121000000.0,40149000000.0
20220307,859249648231,38002845554,34971761819.0,3031083735.0,60540929964,6763967865,331772912,312526794.0,19246118.0,919790578195,798708718267,417154000000.0,158000000.0,42053000000.0
20220308,859765307764,40621032091,40105372558.0,515659533.0,59544810258,6837642138,411571424,337897151.0,73674273.0,919310118022,800220497506,438686000000.0,209000000.0,47560000000.0
20220309,856888363483,40331946755,43208891036.0,-2876944281.0,59701475361,6923094499,494022153,408569792.0,85452361.0,916589838844,797186888122,471789000000.0,216000000.0,48990000000.0
20220310,855756680056,35721876611,36853560038.0,-1131683427.0,60899288776,7020475191,460874164,363493472.0,97380692.0,916655968832,794857391280,417105000000.0,139000000.0,50699000000.0
20220311,853309031318,36722130553,39169779291.0,-2447648738.0,61395468139,7007195509,398066943,411346625.0,-13279682.0,914704499457,791913563179,406451000000.0,111000000.0,52754000000.0
20220314,854517735470,34156710585,32948006433.0,1208704152.0,59635613557,7020451524,342123126,328867111.0,13256015.0,914153349027,794882121913,369471000000.0,113000000.0,49043000000.0
20220315,848623434249,39248985306,45143286527.0,-5894301221.0,57513628861,7107629537,475542741,388364728.0,87178013.0,906137063110,791109805388,459254000000.0,296000000.0,49841000000.0
20220316,846194275056,41493302322,43922461515.0,-2429159193.0,58683148896,6993193567,467580646,582016616.0,-114435970.0,904877423952,787511126160,468784000000.0,226000000.0,54276000000.0
20220317,843697373088,42852969549,45349871517.0,-2496901968.0,59780632258,7095088508,480466387,378571446.0,101894941.0,903478005346,783916740830,474421000000.0,238000000.0,59055000000.0
20220318,837539032759,32741222765,38899563094.0,-6158340329.0,60233391954,7129956740,429085693,394217461.0,34868232.0,897772424713,777305640805,386464000000.0,179000000.0,42759000000.0
20220321,840383540777,35280451221,32435943203.0,2844508018.0,61042001258,7232160304,443213211,341009647.0,102203564.0,901425542035,779341539519,375092000000.0,133000000.0,46809000000.0
20220322,840092127566,31948615138,32240028349.0,-291413211.0,60932585977,7274332627,383722812,341550489.0,42172323.0,901024713543,779159541589,363631000000.0,104000000.0,39900000000.0
20220323,840333260621,33113235366,32872102311.0,241133055.0,61526204201,7301365539,342394536,315361624.0,27032912.0,901859464822,778807056420,368792000000.0,98000000.0,37700000000.0
20220324,839618088604,31089984629,31805156646.0,-715172017.0,61105079215,7286730681,330461726,345096584.0,-14634858.0,900723167819,778513009389,354597000000.0,99000000.0,36510000000.0
20220325,837409442628,31060061466,33268707442.0,-2208645976.0,60059605268,7317497964,355363240,324595957.0,30767283.0,897469047896,777349837360,356902000000.0,103000000.0,33740000000.0
20220328,836838011083,28226118070,28797549615.0,-571431545.0,59865591804,7301136869,361945653,378306748.0,-16361095.0,896703602887,776972419279,344919000000.0,141000000.0,29937000000.0
20220329,835896947038,27762065487,28703129532.0,-941064045.0,59141234094,7288455284,310913876,323595461.0,-12681585.0,895038181132,776755712944,333600000000.0,167000000.0,33233000000.0
20220330,837963805834,34874518471,32807659675.0,2066858796.0,60121859805,7176129112,351834380,464160552.0,-112326172.0,898085665639,777841946029,379071000000.0,237000000.0,35356000000.0
20220331,834878658068,33323175632,36408323398.0,-3085147766.0,59404387646,7161858051,296303659,310574720.0,-14271061.0,894283045714,775474270422,394542000000.0,175000000.0,33898000000.0
20220401,829794726178,31269605890,36353537780.0,-5083931890.0,58502398831,7053935692,317169696,425092055.0,-107922359.0,888297125009,771292327347,375110000000.0,199000000.0,31206000000.0
20220406,833503942754,36268817131,32559600555.0,3709216576.0,58758356633,7126677334,411844709,339103067.0,72741642.0,892262299387,774745586121,398208000000.0,245000000.0,35385000000.0
20220407,831706002323,30739230689,32537171120.0,-1797940431.0,57955025668,7159158507,412167449,379686276.0,32481173.0,889661027991,773750976655,367664000000.0,210000000.0,30650000000.0
20220408,828836634090,31799704613,34669072846.0,-2869368233.0,58449918563,7215779952,413905163,357283718.0,56621445.0,887286552653,770386715527,383385000000.0,242000000.0,31374000000.0
20220411,825857374580,32982315894,35961575404.0,-2979259510.0,56498439856,7224048505,394644957,386376404.0,8268553.0,882355814436,769358934724,404408000000.0,247000000.0,30872000000.0
20220412,824919866194,32701576186,33639084572.0,-937508386.0,57140452706,7162984018,392855065,453919552.0,-61064487.0,882060318900,767779413488,393342000000.0,291000000.0,30388000000.0
20220413,823145306933,30299298345,32073857606.0,-1774559261.0,56661701951,7210724031,382598666,334858653.0,47740013.0,879807008884,766483604982,372076000000.0,291000000.0,26152000000.0
20220414,822208340708,32967755189,33904721414.0,-936966225.0,57457842581,7208223356,355662630,358163305.0,-2500675.0,879666183289,764750498127,368086000000.0,291000000.0,33340000000.0
20220415,818388672866,32955053953,36774721795.0,-3819667842.0,57487330858,7278302397,384627074,314548033.0,70079041.0,875876003724,760901342008,383346000000.0,394000000.0,30831000000.0
20220418,818459315143,29298053925,29227411648.0,70642277.0,56954126509,7221477672,360024869,416849594.0,-56824725.0,875413441652,761505188634,336079000000.0,183000000.0,30962000000.0
20220419,818341922489,26410715343,26528107997.0,-117392654.0,56474168583,7201021558,367875691,388331805.0,-20456114.0,874816091072,761867753906,334923000000.0,213000000.0,28247000000.0
20220420,818724649829,28011197875,27628470535.0,382727340.0,55236348804,7225566963,398817322,374271917.0,24545405.0,873960998633,763488301025,345529000000.0,257000000.0,28068000000.0
20220421,814245491550,26506452438,30985610717.0,-4479158279.0,54094996612,7264944537,450616388,411238814.0,39377574.0,868340488162,760150494938,367786000000.0,209000000.0,29425000000.0
20220422,808088418338,21241215896,27398289108.0,-6157073212.0,53784978649,7290233865,409538574,384249246.0,25289328.0,861873396987,754303439689,320284000000.0,164000000.0,29617000000.0
20220425,798777756593,29535916782,38846578527.0,-9310661745.0,49807748287,7252342872,483164799,521055792.0,-37890993.0,848585504880,748970008306,393793000000.0,315000000.0,33601000000.0
20220426,785342465926,24934800980,38370091647.0,-13435290667.0,48569515995,7262577906,476240509,466005475.0,10235034.0,833911981921,736772949931,364614000000.0,222000000.0,31645000000.0
20220427,779434455889,28641152694,34549162731.0,-5908010037.0,50065757672,7271719006,481213490,472072390.0,9141100.0,829500213561,729368698217,386855000000.0,255000000.0,36312000000.0
20220428,774383614466,26564141949,31614983372.0,-5050841423.0,49704535022,7308715551,440752116,403755571.0,36996545.0,824088149488,724679079444,353221000000.0,272000000.0,35976000000.0
20220429,768384978166,31722518791,37721155091.0,-5998636300.0,49902445908,7115552175,377087902,570251278.0,-193163376.0,818287424074,718482532258,400446000000.0,271000000.0,40254000000.0
20220505,770358757845,31316444374,29342664695.0,1973779679.0,50751399941,7190436721,369868407,294983861.0,74884546.0,821110157786,719607357904,371940000000.0,333000000.0,38225000000.0
20220506,770636270872,27637288223,27359775196.0,277513027.0,50419805818,7258886874,408668586,340218433.0,68450153.0,821056076690,720216465054,315608000000.0,242000000.0,31021000000.0
20220509,772594360832,22707793277,20749703317.0,1958089960.0,50879248692,7331423743,385204432,312667563.0,72536869.0,823473609524,721715112140,274976000000.0,129000000.0,28338000000.0
20220510,773026055278,27256529038,26824834592.0,431694446.0,52106753550,7339307209,467727752,459844286.0,7883466.0,825132808828,720919301728,348229000000.0,234000000.0,37069000000.0
20220511,775240016082,38403416303,36189455499.0,2213960804.0,53013939363,7382840412,481245077,437711874.0,43533203.0,828253955445,722226076719,429846000000.0,197000000.0,46287000000.0
20220512,775606280676,26914556259,26548291665.0,366264594.0,52909367615,7361088230,388976604,410728786.0,-21752182.0,828515648291,722696913061,333683000000.0,150000000.0,35998000000.0
20220513,774154774214,26167766245,27619272707.0,-1451506462.0,53675475425,7372917513,372338060,360508777.0,11829283.0,827830249639,720479298789,311528000000.0,197000000.0,30147000000.0
20220516,775727439591,26612709458,25040044081.0,1572665377.0,53763561213,7445671805,441486773,368732481.0,72754292.0,829491000804,721963878378,317836000000.0,192000000.0,32097000000.0
20220517,775207185635,27111927442,27632181398.0,-520253956.0,53650496250,7363773513,363882188,445780480.0,-81898292.0,828857681885,721556689385,318693000000.0,157000000.0,33671000000.0
20220518,776847783482,27500489730,25859891883.0,1640597847.0,53532469913,7371621666,444023474,436175321.0,7848153.0,830380253395,723315313569,309456000000.0,200000000.0,30474000000.0
20220519,777272455643,28549629945,28124957784.0,424672161.0,52727098167,7080802348,351373585,642192903.0,-290819318.0,829999553810,724545357476,326532000000.0,246000000.0,35891000000.0
20220520,775382706063,33767095002,35656844582.0,-1889749580.0,53183938436,7046384161,425875818,460294005.0,-34418187.0,828566644499,722198767627,377279000000.0,290000000.0,38456000000.0
20220523,778251389141,32521595141,29652912063.0,2868683078.0,53221305635,7001179308,353296401,398501254.0,-45204853.0,831472694776,725030083506,346003000000.0,296000000.0,36093000000.0
20220524,776297399896,33478029692,35432018937.0,-1953989245.0,51651620693,7015920291,448286431,433545448.0,14740983.0,827949020589,724645779203,398130000000.0,230000000.0,40868000000.0
20220525,776948782318,25937119939,25285737517.0,651382422.0,52204915179,7022615469,413871505,407176327.0,6695178.0,829153697497,724743867139,315123000000.0,206000000.0,28863000000.0
20220526,776861193425,29832186051,29919774944.0,-87588893.0,52820379548,7058633343,457431838,421413964.0,36017874.0,829681572973,724040813877,347949000000.0,239000000.0,30292000000.0
20220527,773904370625,27821963225,30778786025.0,-2956822800.0,52583662540,7077719965,425545860,406459238.0,19086622.0,826488033165,721320708085,343215000000.0,275000000.0,29727000000.0
20220530,775287251445,28828692641,27445811821.0,1382880820.0,52697294429,7068071328,375800935,385449572.0,-9648637.0,827984545874,722589957016,344949000000.0,307000000.0,31976000000.0
20220531,775391474256,33689864145,33585641334.0,104222811.0,53057211038,7035432100,404044523,436683751.0,-32639228.0,828448685294,722334263218,387524000000.0,1140000000.0,44963000000.0
20220601,775888801375,31727310989,31229983870.0,497327119.0,51585163239,6879480606,381178041,537129535.0,-155951494.0,827473964614,724303638136,354094000000.0,386000000.0,48932000000.0
20220602,774052689799,33212400666,35048512242.0,-1836111576.0,51135633893,6732059063,357872320,505293863.0,-147421543.0,825188323692,722917055906,348366000000.0,410000000.0,65887000000.0
20220606,779744766199,45572370540,39880294140.0,5692076400.0,51968916749,6696024920,411713519,447747662.0,-36034143.0,831713682948,727775849450,431316000000.0,304000000.0,86607000000.0
20220607,782087338586,40369581839,38027009452.0,2342572387.0,52066610135,6717922195,424711562,402814287.0,21897275.0,834153948721,730020728451,418817000000.0,319000000.0,64278000000.0
20220608,782800121321,42456429312,41743646577.0,712782735.0,52993770720,6780858854,417879945,354943286.0,62936659.0,835793892041,729806350601,442349000000.0,261000000.0,67558000000.0
20220609,783308464450,40170903056,39662559927.0,508343129.0,52404335067,6799639919,418839625,400058560.0,18781065.0,835712799517,730904129383,419133000000.0,251000000.0,49616000000.0
20220610,782256232225,40644204686,41696436911.0,-1052232225.0,53407136031,6804798344,433434045,428275620.0,5158425.0,835663368256,728849096194,444723000000.0,219000000.0,60149000000.0
20220613,788358540702,46456817098,40354508621.0,6102308477.0,52968807177,6719466010,358946148,444278482.0,-85332334.0,841327347879,735389733525,462462000000.0,198000000.0,51220000000.0
20220614,790607292252,46309952318,44061200768.0,2248751550.0,53645550512,6746225243,516131314,489372081.0,26759233.0,844252842764,736961741740,464057000000.0,225000000.0,50366000000.0
20220615,793609922510,60233212499,57230582241.0,3002630258.0,53630674633,6806672978,536441330,475993595.0,60447735.0,847240597143,739979247877,575975000000.0,350000000.0,47623000000.0
20220616,795756728177,46332368237,44185562570.0,2146805667.0,54303015634,6829715717,513905855,490863116.0,23042739.0,850059743811,741453712543,461679000000.0,227000000.0,45665000000.0
20220617,793940350029,42842107943,44658486091.0,-1816378148.0,55290070732,6912217032,488522030,406020715.0,82501315.0,849230420761,738650279297,448039000000.0,258000000.0,50511000000.0
20220620,798401593884,47621368258,43160124403.0,4461243855.0,55919104321,6947200236,436995541,402012337.0,34983204.0,854320698205,742482489563,475117000000.0,321000000.0,54146000000.0
20220621,796791144096,40973948034,42584397822.0,-1610449788.0,56654901493,7081932430,546112960,411380766.0,134732194.0,853446045589,740136242603,423396000000.0,165000000.0,49040000000.0
20220622,799032181409,39381731122,37140693809.0,2241037313.0,56795824636,7202903031,533081862,412111261.0,120970601.0,855828006045,742236356773,391555000000.0,172000000.0,50774000000.0
20220623,799470136679,43485869406,43047914136.0,437955270.0,58406024132,7303722166,593666045,492846910.0,100819135.0,857876160811,741064112547,425158000000.0,297000000.0,52415000000.0
20220624,799101774063,46175566005,46543928621.0,-368362616.0,59505969329,7331298421,486506974,458930719.0,27576255.0,858607743392,739595804734,449252000000.0,189000000.0,61213000000.0
20220627,804152526967,51884714653,46833961749.0,5050752904.0,59791030542,7395969503,499412140,434741058.0,64671082.0,863943557509,744361496425,484299000000.0,253000000.0,58851000000.0
20220628,808027652202,50553431904,46678306669.0,3875125235.0,59815485114,7267810692,421878756,550037567.0,-128158811.0,867843137316,748212167088,468871000000.0,208000000.0,59689000000.0
20220629,807930379714,50628051048,50725323536.0,-97272488.0,59077158831,7282918953,497907556,482799295.0,15108261.0,867007538545,748853220883,498003000000.0,233000000.0,64665000000.0
20220630,810173314834,48938425785,46695490665.0,2242935120.0,60817834131,7374838978,509409100,417489075.0,91920025.0,870991148965,749355480703,454040000000.0,218000000.0,57989000000.0
20220701,807893323016,41649257686,43929249504.0,-2279991818.0,60713899537,7409562756,489681818,454958040.0,34723778.0,868607222553,747179423479,407034000000.0,159000000.0,51970000000.0
20220704,811494011440,44184226573,40583538149.0,3600688424.0,61911620491,7380297182,470668061,499933635.0,-29265574.0,873405631931,749582390949,429098000000.0,144000000.0,60910000000.0
20220705,813443887342,46991426779,45041550877.0,1949875902.0,62508003069,7511448730,579793979,448642431.0,131151548.0,875951890411,750935884273,463647000000.0,182000000.0,54125000000.0
20220706,815649145513,43176377194,40971119023.0,2205258171.0,61882153159,7417321964,442466243,536593009.0,-94126766.0,877531298672,753766992354,432001000000.0,200000000.0,56385000000.0
20220707,816739788005,38432399454,37341756962.0,1090642492.0,62799030682,7514044921,511952501,415229544.0,96722957.0,879538818687,753940757323,382905000000.0,136000000.0,56306000000.0
20220708,815301810057,36901495340,38339473288.0,-1437977948.0,62516717201,7496149470,471137309,489032760.0,-17895451.0,877818527258,752785092856,371604000000.0,167000000.0,52845000000.0
20220711,815819236317,35840995623,35323569363.0,517426260.0,61525665140,7505888510,470542673,460803633.0,9739040.0,877344901457,754293571177,375125000000.0,150000000.0,50689000000.0
20220712,814427103321,33023882202,34416015198.0,-1392132996.0,60590080802,7558058678,487248995,435078827.0,52170168.0,875017184123,753837022519,360386000000.0,119000000.0,51146000000.0
20220713,814864156128,31953471126,31516418319.0,437052807.0,61059706506,7540048417,451432077,469442338.0,-18010261.0,875923862634,753804449622,348087000000.0,150000000.0,46865000000.0
20220714,816457913392,36646453803,35052696539.0,1593757264.0,61663350657,7556219418,475522882,459351881.0,16171001.0,878121264049,754794562735,380612000000.0,189000000.0,51992000000.0
20220715,814971261389,37629148735,39115800738.0,-1486652003.0,61484021300,7577495924,477429422,456152916.0,21276506.0,876455282689,753487240089,411877000000.0,261000000.0,50292000000.0
20220718,816693870032,33996089175,32273480532.0,1722608643.0,62363955895,7542419418,412043919,447120425.0,-35076506.0,879057825927,754329914137,371579000000.0,171000000.0,53253000000.0
20220719,818368021163,32107635239,30433484108.0,1674151131.0,62682997977,7620539324,463112844,384992938.0,78119906.0,881051019140,755685023186,346974000000.0,132000000.0,50235000000.0
20220720,819291476832,32845807949,31922352280.0,923455669.0,63207502714,7653354534,404783807,371968597.0,32815210.0,882498979546,756083974118,335881000000.0,101000000.0,48579000000.0
20220721,820120344143,36486633015,35657765704.0,828867311.0,62845739998,7586361524,419220221,486213231.0,-66993010.0,882966084141,757274604145,363251000000.0,151000000.0,58519000000.0
20220722,819125924113,31598198519,32592618549.0,-994420030.0,63428133072,7627876510,487471265,445956279.0,41514986.0,882554057185,755697791041,330781000000.0,142000000.0,53452000000.0
20220725,818877487640,26605640093,26854076566.0,-248436473.0,63315557034,7733793268,510277286,404360528.0,105916758.0,882193044674,755561930606,298203000000.0,94000000.0,51195000000.0
20220726,818271843241,26296720021,26902364420.0,-605644399.0,63735038595,7702906332,410147830,441034766.0,-30886936.0,882006881836,754536804646,288119000000.0,99000000.0,47215000000.0
20220727,819846008863,27682660786,26108495164.0,1574165622.0,64161423121,7653129218,365661409,415438523.0,-49777114.0,884007431984,755684585742,288177000000.0,143000000.0,53013000000.0
20220728,820081385003,32908914029,32673537889.0,235376140.0,64570753061,7687158148,464982506,430953576.0,34028930.0,884652138064,755510631942,334545000000.0,218000000.0,62173000000.0
20220729,818061069544,31822181298,33842496757.0,-2020315459.0,63864994896,7675955930,458048151,469250369.0,-11202218.0,881926064440,754196074648,352345000000.0,215000000.0,58513000000.0
20220801,818992456447,31178592295,30247205392.0,931386903.0,64215210576,7683419170,410368695,402905455.0,7463240.0,883207667023,754777245871,341481000000.0,140000000.0,58327000000.0
20220802,813462510618,35377146872,40907092701.0,-5529945829.0,63261255414,7732617092,533775056,484577134.0,49197922.0,876723766032,750201255204,408607000000.0,329000000.0,67523000000.0
20220803,812291833769,35871316460,37041993309.0,-1170676849.0,63546053793,7905362691,633056485,460310886.0,172745599.0,875837887562,748745779976,377895000000.0,157000000.0,78521000000.0
20220804,813705139650,28416543518,27003237637.0,1413305881.0,64511564452,8145387298,675106377,435081770.0,240024607.0,878216704102,749193575198,311004000000.0,194000000.0,61246000000.0
20220805,813049843823,34390585662,35045881489.0,-655295827.0,66718746809,8324883207,629819525,450323616.0,179495909.0,879768590632,746331097014,329004000000.0,167000000.0,86234000000.0
20220808,814640869080,31536561905,29945536648.0,1591025257.0,67325512668,8426558141,444880412,343205478.0,101674934.0,881966381748,747315356412,313220000000.0,147000000.0,80387000000.0
20220809,816962196621,31711301756,29389974215.0,2321327541.0,67835090165,8474192955,403661541,356026727.0,47634814.0,884797286786,749127106456,322212000000.0,147000000.0,70827000000.0
20220810,818375102481,32201768047,30788862187.0,1412905860.0,67670779003,8467456202,369203520,375940273.0,-6736753.0,886045881484,750704323478,319982000000.0,126000000.0,72238000000.0
20220811,818175734041,37674496174,37873864614.0,-199368440.0,68929652326,8504352629,468928007,432031580.0,36896427.0,887105386367,749246081715,357321000000.0,219000000.0,71495000000.0
20220812,815776022678,32741042484,35140753847.0,-2399711363.0,68627101865,8549074354,454255752,409534027.0,44721725.0,884403124543,747148920813,333502000000.0,161000000.0,71461000000.0
20220815,817951632910,32660333036,30484722804.0,2175610232.0,68246585573,8426693989,376459692,498840057.0,-122380365.0,886198218483,749705047337,327518000000.0,157000000.0,61093000000.0
20220816,819254198291,33860919426,32558354045.0,1302565381.0,68789483520,8478784107,463062809,410972691.0,52090118.0,888043681811,750464714771,347125000000.0,157000000.0,63132000000.0
20220817,820026080300,35056653572,34284771563.0,771882009.0,69335777525,8530232389,490555737,439107455.0,51448282.0,889361857825,750690302775,360888000000.0,171000000.0,64341000000.0
20220818,821505494211,34424608214,32945194303.0,1479413911.0,70060666031,8568077665,475285798,437440522.0,37845276.0,891566160242,751444828180,344357000000.0,130000000.0,74962000000.0
20220819,818796898343,36597143211,39305739079.0,-2708595868.0,68973265062,8582375879,445368439,431070225.0,14298214.0,887770163405,749823633281,380354000000.0,277000000.0,78421000000.0
20220822,819764989605,33511752383,32543661121.0,968091262.0,69738009821,8698741605,522687266,406321540.0,116365726.0,889502999426,750026979784,358783000000.0,231000000.0,70142000000.0
20220823,821273324019,34333619919,32825285505.0,1508334414.0,70332089957,8963926435,678213318,413028488.0,265184830.0,891605413976,750941234062,357353000000.0,289000000.0,62730000000.0
20220824,818520354358,35823734058,38576703719.0,-2752969661.0,68587982412,9118815508,598446613,443557540.0,154889073.0,887108336770,749932371946,390557000000.0,310000000.0,68225000000.0
20220825,816965812332,32208838770,33763380796.0,-1554542026.0,68921511628,9199075065,520935438,440675881.0,80259557.0,885887323960,748044300704,362785000000.0,345000000.0,57514000000.0
20220826,813729709479,27455992496,30692095349.0,-3236102853.0,69313799949,9330815773,483549747,351809039.0,131740708.0,883043509428,744415909530,341601000000.0,225000000.0,56320000000.0
20220829,814151763169,26099736281,25677682591.0,422053690.0,68928377843,9565632119,489002506,254186160.0,234816346.0,883080141012,745223385326,310080000000.0,211000000.0,54696000000.0
20220830,812992456940,25489676641,26648982870.0,-1159306229.0,68519738825,9549272306,451687153,468046966.0,-16359813.0,881512195765,744472718115,305264000000.0,236000000.0,49296000000.0
20220831,807729362103,29590569191,34853664028.0,-5263094837.0,67641547722,9685817846,657524169,520978629.0,136545540.0,875370909825,740087814381,373870000000.0,312000000.0,57980000000.0
20220901,805956223789,22785085346,24558223660.0,-1773138314.0,67626600084,9674226619,420425339,432016566.0,-11591227.0,873582823873,738329623705,288206000000.0,182000000.0,50128000000.0
20220902,804547309813,21929299716,23338213692.0,-1408913976.0,67846342686,9617322440,382832601,439736780.0,-56904179.0,872393652499,736700967127,264127000000.0,147000000.0,49838000000.0
20220905,804717543345,24010007024,23839773492.0,170233532.0,68217966804,7995303768,522735556,2144754228.0,-1622018672.0,872935510149,736499576541,289903000000.0,194000000.0,50081000000.0
20220906,803513344268,27800142775,29004341852.0,-1204199077.0,69481020611,8024105463,431669320,402867625.0,28801695.0,872994364879,734032323657,330204000000.0,229000000.0,49743000000.0
20220907,804203104743,27853115750,27163355275.0,689760475.0,69805592535,8040312203,384565762,368359022.0,16206740.0,874008697278,734397512208,316926000000.0,173000000.0,55065000000.0
20220908,802936935915,23961974540,25228143368.0,-1266168828.0,69498455458,8068443516,372832193,344700880.0,28131313.0,872435391373,733438480457,284824000000.0,209000000.0,44443000000.0
20220909,797665884010,23834570929,29105622834.0,-5271051905.0,69348638154,8009367516,419210034,478286034.0,-59076000.0,867014522164,728317245856,297575000000.0,168000000.0,45179000000.0
20220913,799641281579,26155022955,24179625386.0,1975397569.0,69852396881,8058462163,386597799,337503152.0,49094647.0,869493678460,729788884698,296538000000.0,227000000.0,43391000000.0
20220914,799281463122,23265486232,23625304689.0,-359818457.0,69444444184,8044937931,382151574,395675806.0,-13524232.0,868725907306,729837018938,265373000000.0,232000000.0,43293000000.0
20220915,796544742207,28557210441,31293931356.0,-2736720915.0,68322179307,8158071040,535590337,422457228.0,113133109.0,864866921514,728222562900,337580000000.0,237000000.0,55546000000.0
20220916,793641670445,24450668225,27353739987.0,-2903071762.0,66812393359,8155522310,453752132,456300862.0,-2548730.0,860454063804,726829277086,309300000000.0,374000000.0,46887000000.0
20220919,791758426442,18923812969,20807056972.0,-1883244003.0,66723565869,8223044097,465711231,398189444.0,67521787.0,858481992311,725034860573,245333000000.0,150000000.0,45099000000.0
20220920,792317272001,19654660682,19095815123.0,558845559.0,67723390752,8293175265,427448889,357317721.0,70131168.0,860040662753,724593881249,231542000000.0,153000000.0,38805000000.0
20220921,792373742514,19510872336,19454401823.0,56470513.0,67466886141,8328622696,451876089,416428658.0,35447431.0,859840628655,724906856373,233996000000.0,120000000.0,37299000000.0
20220922,791371965565,19798752526,20800529475.0,-1001776949.0,67420878401,8290020067,381731244,420333873.0,-38602629.0,858792843966,723951087164,233818000000.0,135000000.0,38277000000.0
20220923,787247836470,19496402651,23620531746.0,-4124129095.0,66418539201,8282498987,433244770,440765850.0,-7521080.0,853666375671,720829297269,247243000000.0,339000000.0,41179000000.0
20220926,785774425677,20067682944,21541093737.0,-1473410793.0,65068764666,8173447663,416576533,525627857.0,-109051324.0,850843190343,720705661011,253014000000.0,624000000.0,40955000000.0
20220927,785240104940,19878687696,20413008433.0,-534320737.0,66091755915,8065160723,418747499,527034439.0,-108286940.0,851331860855,719148349025,251361000000.0,255000000.0,42905000000.0
20220928,781113221616,17589202162,21716085486.0,-4126883324.0,64718874306,8059695502,434609094,440074315.0,-5465221.0,845832095922,716394347310,239829000000.0,200000000.0,38505000000.0
20220929,778830915826,18390339803,20672645593.0,-2282305790.0,63789998932,7884254334,373087685,548528853.0,-175441168.0,842620914758,715040916894,237628000000.0,169000000.0,39920000000.0
20220930,770623751931,13867959000,22075122895.0,-8207163895.0,61980206085,7747368483,353753815,490639666.0,-136885851.0,832603958016,708643545846,206083000000.0,150000000.0,35302000000.0
20221010,771203514053,20021628982,19441866860.0,579762122.0,60460888802,7769766475,426957702,404559710.0,22397992.0,831664402855,710742625251,245531000000.0,204000000.0,44800000000.0
20221011,770735102720,16395842232,16864253565.0,-468411333.0,60942006203,7750938758,431844219,450671936.0,-18827717.0,831677108923,709793096517,209095000000.0,138000000.0,38513000000.0
20221012,771370482389,23835677500,23200297831.0,635379669.0,63259946092,7851311771,555564374,455191361.0,100373013.0,834630428481,708110536297,259382000000.0,221000000.0,48038000000.0
20221013,772376809092,23535235092,22528908389.0,1006326703.0,63634478610,7910990923,471532790,411853638.0,59679152.0,836011287702,708742330482,269310000000.0,155000000.0,49319000000.0
20221014,772023311463,29856859671,30210357300.0,-353497629.0,65651636507,7882573380,477227508,505645051.0,-28417543.0,837674947970,706371674956,310270000000.0,191000000.0,62799000000.0
20221017,773363951153,27676632060,26335992370.0,1340639690.0,66354123433,7864495824,414621510,432699066.0,-18077556.0,839718074586,707009827720,283076000000.0,129000000.0,66745000000.0
20221018,773992838909,25724901685,25096013929.0,628887756.0,67445030416,7995417220,479571845,348650449.0,130921396.0,841437869325,706547808493,267411000000.0,161000000.0,59267000000.0
20221019,775306396795,24274840803,22961282917.0,1313557886.0,66868108922,8000837867,383143030,377722383.0,5420647.0,842174505717,708438287873,259902000000.0,162000000.0,53521000000.0
20221020,776269929247,26883206762,25919674310.0,963532452.0,68130975055,8248303204,653835823,406370486.0,247465337.0,844400904302,708138954192,274530000000.0,179000000.0,66093000000.0
20221021,773692767359,23127096298,25704258186.0,-2577161888.0,68291178351,8255373809,472408157,465337552.0,7070605.0,841983945710,705401589008,258120000000.0,145000000.0,57146000000.0
20221024,774821459548,32790490624,31661798435.0,1128692189.0,67595042357,8313594807,558011235,499790237.0,58220998.0,842416501905,707226417191,331979000000.0,315000000.0,63238000000.0
20221025,773969828275,24854361339,25705992612.0,-851631273.0,67547329350,8314082319,500771313,500283801.0,487512.0,841517157625,706422498925,278859000000.0,206000000.0,59173000000.0
20221026,775833466675,30907985414,29044347014.0,1863638400.0,68412991694,8152533788,497646331,659194862.0,-161548531.0,844246458369,707420474981,301552000000.0,228000000.0,72051000000.0
20221027,774796204610,29277661794,30314923859.0,-1037262065.0,68318608870,8182116678,492279833,462696943.0,29582890.0,843114813480,706477595740,308735000000.0,172000000.0,72890000000.0
20221028,768599549673,26785595840,32982250777.0,-6196654937.0,66464225035,8159625569,489692213,512183322.0,-22491109.0,835063774708,702135324638,314714000000.0,233000000.0,70964000000.0
20221031,768736970587,28965833092,28828412178.0,137420914.0,66991486894,8161947094,485347010,483025485.0,2321525.0,835728457481,701745483693,319638000000.0,332000000.0,78110000000.0
20221101,769667966856,33053275067,32122278798.0,930996269.0,68592932538,8197543085,547412241,511816250.0,35595991.0,838260899394,701075034318,360315000000.0,219000000.0,72014000000.0
20221102,770284229577,36947176392,36330913671.0,616262721.0,69157555118,8154936579,483701840,526308346.0,-42606506.0,839441784695,701126674459,376119000000.0,185000000.0,82256000000.0
20221103,772623348328,29779927512,27440808761.0,2339118751.0,69051958105,8069899356,406979053,492016276.0,-85037223.0,841675306433,703571390223,295408000000.0,125000000.0,77066000000.0
20221104,772462692744,39413824543,39574480127.0,-160655584.0,69624982497,7944796342,555394573,680497587.0,-125103014.0,842087675241,702837710247,380009000000.0,211000000.0,80137000000.0
20221107,775900520228,36692366299,33254538815.0,3437827484.0,68554557244,7902441104,494577130,536932368.0,-42355238.0,844455077472,707345962984,351444000000.0,149000000.0,74887000000.0
20221108,777224082043,27431361085,26107799270.0,1323561815.0,68109226287,7868119836,408835598,443156866.0,-34321268.0,845333308330,709114855756,279427000000.0,123000000.0,60857000000.0
20221109,777824824498,25183520037,24582777582.0,600742455.0,67446351571,7827237928,344075536,384957444.0,-40881908.0,845271176069,710378472927,253783000000.0,137000000.0,55675000000.0
20221110,777550981686,26487720456,26761563268.0,-273842812.0,67264167767,7852046992,490485573,465676509.0,24809064.0,844815149453,710286813919,273052000000.0,135000000.0,64299000000.0
20221111,773552787965,42433322610,46431516331.0,-3998193721.0,67274401724,7715467968,514797310,651376334.0,-136579024.0,840827189689,706278386241,435010000000.0,218000000.0,79422000000.0
20221114,773920229118,35957773092,35590331939.0,367441153.0,66743896074,7727232277,506223716,494459407.0,11764309.0,840664125192,707176333044,391662000000.0,226000000.0,64035000000.0
20221115,775706762626,39324289597,37537756089.0,1786533508.0,68504011545,7721323206,550064841,555973912.0,-5909071.0,844210774171,707202751081,371726000000.0,194000000.0,76452000000.0
20221116,775839406247,32292268511,32159624890.0,132643621.0,67645128058,7701842799,440110154,459590561.0,-19480407.0,843484534305,708194278189,326515000000.0,181000000.0,62015000000.0
20221117,777288642064,32481113899,31031878082.0,1449235817.0,67960162820,7604932457,468478702,565389044.0,-96910342.0,845248804884,709328479244,314355000000.0,301000000.0,64624000000.0
20221118,774607255920,31935381317,34616767461.0,-2681386144.0,65638328535,7417572694,446997380,634357143.0,-187359763.0,840245584455,708968927385,324276000000.0,238000000.0,66249000000.0
20221121,777077218098,28293261410,25823299232.0,2469962178.0,64943264614,7368084011,472814923,522303606.0,-49488683.0,842020482712,712133953484,289124000000.0,125000000.0,56833000000.0
20221122,776834636854,30864366469,31106947713.0,-242581244.0,64067523773,7428142622,567541921,507483310.0,60058611.0,840902160627,712767113081,317344000000.0,187000000.0,57893000000.0
20221123,777002601688,29313190599,29145225765.0,167964834.0,63708252821,7430593107,533701525,531251040.0,2450485.0,840710854509,713294348867,299871000000.0,193000000.0,58152000000.0
20221124,776161135356,24182818630,25024284962.0,-841466332.0,64252687919,7475602830,492463165,447453442.0,45009723.0,840413823275,711908447437,259727000000.0,153000000.0,49928000000.0
20221125,772544316046,23969432803,27586252113.0,-3616819310.0,63653489773,7490419318,517895242,503078754.0,14816488.0,836197805819,708890826273,280533000000.0,100000000.0,46767000000.0
20221128,772868801219,26858193078,26533707905.0,324485173.0,62464324929,7402017115,461545564,549947767.0,-88402203.0,835333126148,710404476290,292396000000.0,141000000.0,47316000000.0
20221129,773818172180,38087593766,37138222805.0,949370961.0,63248254585,7472116345,628018116,557918886.0,70099230.0,837066426765,710569917595,383653000000.0,220000000.0,57475000000.0
20221130,771424149549,30399589348,32793611979.0,-2394022631.0,62484447264,7457688672,524244050,538671723.0,-14427673.0,833908596813,708939702285,351132000000.0,375000000.0,53643000000.0
20221201,773006882074,38793135489,37210402964.0,1582732525.0,62302017268,7353539317,455233907,559383262.0,-104149355.0,835308899342,710704864806,401991000000.0,175000000.0,61766000000.0
20221202,772184356386,29155770062,29978295750.0,-822525688.0,60759429440,7188623061,445661375,610577631.0,-164916256.0,832943785826,711424926946,312136000000.0,159000000.0,55477000000.0
20221205,776039754984,42871935274,39016536676.0,3855398598.0,61216860136,7299457815,590576934,479742180.0,110834754.0,837256615120,714822894848,420307000000.0,196000000.0,60069000000.0
20221206,776103539100,36375765216,36311981100.0,63784116.0,60983181033,7243747526,450641379,506351668.0,-55710289.0,837086720133,715120358067,377272000000.0,173000000.0,59216000000.0
20221207,777182938303,34852447964,33773048761.0,1079399203.0,60809679806,7246603286,509991630,507135870.0,2855760.0,837992618109,716373258497,351393000000.0,197000000.0,52973000000.0
20221208,777198575304,29953697411,29938060410.0,15637001.0,60936788485,7278045929,428136294,396693651.0,31442643.0,838135363789,716261786819,315205000000.0,167000000.0,52182000000.0
20221209,776138478545,33791776732,34851873491.0,-1060096759.0,60948571736,7203726270,476407422,550727081.0,-74319659.0,837087050281,715189906809,374549000000.0,136000000.0,75058000000.0
20221212,779477957495,33348971402,30009492452.0,3339478950.0,60419639246,7073753236,432499389,562472423.0,-129973034.0,839897596741,719058318249,334994000000.0,139000000.0,62021000000.0
20221213,778706150308,23842285880,24614093067.0,-771807187.0,59880719357,7023878684,320918527,370793079.0,-49874552.0,838586869665,718825430951,285456000000.0,130000000.0,49540000000.0
20221214,777087007843,28121653373,29740795838.0,-1619142465.0,59844226632,7000325556,457945932,481499060.0,-23553128.0,836931234475,717242781211,284426000000.0,138000000.0,51936000000.0
20221215,777754941694,24966536463,24298602612.0,667933851.0,59690169852,6953131685,465319236,512513107.0,-47193871.0,837445111546,718064771842,263757000000.0,74000000.0,42862000000.0
20221216,774732973259,22599879266,25621847701.0,-3021968435.0,59364086665,6978801390,449600870,423931165.0,25669705.0,834097059924,715368886594,264403000000.0,174000000.0,43708000000.0
20221219,773295688119,25693480619,27130765759.0,-1437285140.0,57931388701,6914424322,485538339,549915407.0,-64377068.0,831227076820,715364299418,269993000000.0,138000000.0,39223000000.0
20221220,773741005498,20367794636,19922477257.0,445317379.0,57279770334,6900584458,484635519,498475383.0,-13839864.0,831020775832,716461235164,230418000000.0,90000000.0,32391000000.0
20221221,772131190941,16297029837,17906844394.0,-1609814557.0,57013919879,6881438251,404833420,423979627.0,-19146207.0,829145110820,715117271062,196963000000.0,69000000.0,31121000000.0
20221222,770308253069,20572824853,22395762725.0,-1822937872.0,56658280171,6887320638,438827097,432944710.0,5882387.0,826966533240,713649972898,234924000000.0,95000000.0,33089000000.0
20221223,767808102655,17297446476,19797596890.0,-2500150414.0,56044709502,6860257165,463497372,490560845.0,-27063473.0,823852812157,711763393153,200103000000.0,219000000.0,35294000000.0
20221226,769283179666,19941179477,18466102466.0,1475077011.0,57204574946,6848777529,367496800,378976436.0,-11479636.0,826487754612,712078604720,216921000000.0,98000000.0,40573000000.0
20221227,768300105500,21088507725,22071581891.0,-983074166.0,57820141009,6916107608,458934286,391604207.0,67330079.0,826120246509,710479964491,229160000000.0,105000000.0,41004000000.0
20221228,766472799612,18237066622,20064372510.0,-1827305888.0,57798601098,6934872196,401425334,382660746.0,18764588.0,824271400710,708674198514,226674000000.0,69000000.0,35993000000.0
20221229,766760403679,18918496091,18630892024.0,287604067.0,57934262914,7040645548,521047974,415274622.0,105773352.0,824694666593,708826140765,219831000000.0,73000000.0,34980000000.0
20221230,762514201807,16023998297,20270200169.0,-4246201872.0,57481916398,7057585015,499473735,482534268.0,16939467.0,819996118205,705032285409,217921000000.0,116000000.0,33400000000.0
20230103,764350187189,26269848785,24433863403.0,1835985382.0,57213980296,6862759148,445888539,640714406.0,-194825867.0,821564167485,707136206893,284913000000.0,128000000.0,47436000000.0
20230104,764418863386,23466972941,23398296744.0,68676197.0,57419073503,6927554764,530551124,465755508.0,64795616.0,821837936889,706999789883,273679000000.0,121000000.0,43594000000.0
20230105,764779384596,26348490112,25987968902.0,360521210.0,58350501542,6917985699,452755366,462324431.0,-9569065.0,823129886138,706428883054,289901000000.0,129000000.0,47229000000.0
20230106,763344296620,26190740179,27625828155.0,-1435087976.0,58366274215,6827350153,417364751,508000297.0,-90635546.0,821710570835,704978022405,287691000000.0,136000000.0,51838000000.0
20230109,764824244326,28651317201,27171369495.0,1479947706.0,58693893160,6886158803,450907620,392098970.0,58808650.0,823518137486,706130351166,296171000000.0,137000000.0,48399000000.0
20230110,764994925871,25231350747,25060669202.0,170681545.0,58717235669,6880562487,378409698,384006014.0,-5596316.0,823712161540,706277690202,268653000000.0,111000000.0,44047000000.0
20230111,763770671980,24005209350,25229463241.0,-1224253891.0,58337995594,6859696916,390331349,411196920.0,-20865571.0,822108667574,705432676386,265136000000.0,238000000.0,46255000000.0
20230112,762379933298,21703105873,23093844555.0,-1390738682.0,58599665132,6836208610,378111605,401599911.0,-23488306.0,820979598430,703780268166,235066000000.0,149000000.0,41215000000.0
20230113,759845686031,23173898664,25708145931.0,-2534247267.0,59479935478,6832619186,402986733,406576157.0,-3589424.0,819325621509,700365750553,249181000000.0,91000000.0,41971000000.0
20230116,760316664530,35534790586,35063812087.0,470978499.0,59928133409,6684054778,456113165,604677573.0,-148564408.0,820244797939,700388531121,354967000000.0,149000000.0,60851000000.0
20230117,758825329203,23874455214,25365790541.0,-1491335327.0,59669539891,6636924408,400544568,447674938.0,-47130370.0,818494869094,699155789312,254339000000.0,109000000.0,49991000000.0
20230118,756622347867,21287640240,23490621576.0,-2202981336.0,58901754251,6502505019,294571182,428990571.0,-134419389.0,815524102118,697720593616,227679000000.0,142000000.0,40957000000.0
20230119,755726974240,25505153144,26400526771.0,-895373627.0,59208561771,6356226331,353007803,499286491.0,-146278688.0,814935536011,696518412469,249848000000.0,184000000.0,48160000000.0
20230120,747919975441,28442552716,36249551515.0,-7806998799.0,58426085977,6125230222,255265772,486261881.0,-230996109.0,806346061418,689493889464,283240000000.0,183000000.0,46080000000.0
20230130,758324039887,44182544303,33778479857.0,10404064446.0,57662644387,6291917882,478613981,311926321.0,166687660.0,815986684274,700661395500,387406000000.0,217000000.0,66724000000.0
20230131,761554614916,32944039881,29713464852.0,3230575029.0,56868675926,6253829172,403995014,442083724.0,-38088710.0,818423290842,704685938990,321435000000.0,193000000.0,55043000000.0
20230201,765593071927,38596177407,34557720396.0,4038457011.0,57879344454,6346691008,478144906,385283070.0,92861836.0,823472416381,707713727473,354811000000.0,169000000.0,60043000000.0
20230202,767838008722,38482533499,36237596704.0,2244936795.0,58661906036,6383665829,472231031,435256210.0,36974821.0,826499914758,709176102686,363609000000.0,146000000.0,67693000000.0
20230203,768724731038,33723508407,32836786091.0,886722316.0,58636081553,6363340352,464177639,484503116.0,-20325477.0,827360812591,710088649485,321490000000.0,143000000.0,58091000000.0
20230206,771265612492,30871164379,28330282925.0,2540881454.0,58450949920,6356188861,499283483,506434974.0,-7151491.0,829716562412,712814662572,289703000000.0,144000000.0,59820000000.0
20230207,773091617246,28077917457,26251912703.0,1826004754.0,59135979568,6458353608,511921669,409756922.0,102164747.0,832227596814,713955637678,262925000000.0,88000000.0,59252000000.0
20230208,773692157939,25263749848,24663209155.0,600540693.0,58987511030,6509557099,424020754,372817263.0,51203491.0,832679668969,714704646909,241369000000.0,89000000.0,53061000000.0
20230209,773789184027,30714147343,30617121255.0,97026088.0,60666614866,6522908581,479672832,466321350.0,13351482.0,834455798893,713122569161,286616000000.0,239000000.0,66678000000.0
20230210,772176553297,28454742865,30067373595.0,-1612630730.0,60233235214,6529405240,481021931,474525272.0,6496659.0,832409788511,711943318083,276581000000.0,123000000.0,66523000000.0
20230213,775115514066,34203591703,31264630934.0,2938960769.0,60336878016,6521528525,493899094,501775809.0,-7876715.0,835452392082,714778636050,331254000000.0,135000000.0,67618000000.0
20230214,776791296318,30447188784,28771406532.0,1675782252.0,60271399307,6508139361,429781586,443170750.0,-13389164.0,837062695625,716519897011,297860000000.0,104000000.0,59198000000.0
20230215,778814595507,32199142338,30175843149.0,2023299189.0,60659772698,6549197613,462720365,421662113.0,41058252.0,839474368205,718154822809,294689000000.0,107000000.0,63790000000.0
20230216,777614732387,42753088780,43952951900.0,-1199863120.0,60074297316,6608957137,598874330,539114806.0,59759524.0,837689029703,717540435071,393199000000.0,183000000.0,75913000000.0
20230217,775379729131,28747268997,30982272253.0,-2235003256.0,59149363469,6501904077,468847437,575900497.0,-107053060.0,834529092600,716230365662,299702000000.0,143000000.0,56249000000.0
20230220,777618595903,35628718244,33389851472.0,2238866772.0,60505211610,6626532533,650051079,525422623.0,124628456.0,838123807513,717113384293,343783000000.0,135000000.0,54996000000.0
20230221,778991977830,35195700903,33822318976.0,1373381927.0,60297565226,6708063823,566903318,485372028.0,81531290.0,839289543056,718694412604,338421000000.0,129000000.0,53029000000.0
20230222,780900121090,28726816154,26818672894.0,1908143260.0,60054621098,6736958279,455720903,426826447.0,28894456.0,840954742188,720845499992,273893000000.0,112000000.0,47384000000.0
20230223,781042560533,29265249647,29122810204.0,142439443.0,59941122756,6787882686,497576934,446652527.0,50924407.0,840983683289,721101437777,286395000000.0,93000000.0,48795000000.0
20230224,780666428046,26922542436,27298674923.0,-376132487.0,58969017855,6701327844,447133832,533688674.0,-86554842.0,839635445901,721697410191,263154000000.0,82000000.0,45501000000.0
20230227,780503115387,26558966376,26722279035.0,-163312659.0,58164049606,6721526358,520045516,499847002.0,20198514.0,838667164993,722339065781,272888000000.0,107000000.0,52382000000.0
20230228,780900136995,27200620472,26803598864.0,397021608.0,57781281778,6659381693,463086630,525231295.0,-62144665.0,838681418773,723118855217,266554000000.0,181000000.0,52819000000.0
20230301,781822473154,35308992850,34386656691.0,922336159.0,58689745794,6734831452,567416295,491966536.0,75449759.0,840512218948,723132727360,325436000000.0,155000000.0,60734000000.0
20230302,781178829117,33989864554,34633508591.0,-643644037.0,58425274731,6730586569,449943327,454188210.0,-4244883.0,839604103848,722753554386,330267000000.0,101000000.0,60975000000.0
20230303,780729766109,35621014751,36070077759.0,-449063008.0,58906191476,6791993108,575898753,514492214.0,61406539.0,839635957585,721823574633,330148000000.0,89000000.0,59379000000.0
20230306,783317669963,38130658311,35542754457.0,2587903854.0,59434100431,6824305235,544520836,512208709.0,32312127.0,842751770394,723883569532,364770000000.0,124000000.0,68335000000.0
20230307,782936967560,37584155624,37964858027.0,-380702403.0,58485896449,6823715107,561062984,561653112.0,-590128.0,841422864009,724451071111,371480000000.0,146000000.0,59240000000.0
20230308,784081753629,27177785002,26032998933.0,1144786069.0,58141530889,6716643544,458706880,565778443.0,-107071563.0,842223284518,725940222740,261728000000.0,89000000.0,51854000000.0
20230309,785759082363,28751641632,27074312898.0,1677328734.0,58568937176,6765492286,560661303,511812561.0,48848742.0,844328019539,727190145187,270278000000.0,89000000.0,59503000000.0
20230310,783197568414,28706138749,31267652698.0,-2561513949.0,57253867475,6637325012,530153517,658320791.0,-128167274.0,840451435889,725943700939,281300000000.0,120000000.0,61643000000.0
20230313,783799930630,31700153724,31097791508.0,602362216.0,57611243790,6705327275,561642955,493640692.0,68002263.0,841411174420,726188686840,305653000000.0,142000000.0,60852000000.0
20230314,786046973151,37826288637,35579246116.0,2247042521.0,57277312922,6655015938,540912991,591224328.0,-50311337.0,843324286073,728769660229,336005000000.0,149000000.0,74523000000.0
20230315,786734165922,33710304348,33023111577.0,687192771.0,57374956856,6686525580,522934621,491424979.0,31509642.0,844109122778,729359209066,304221000000.0,119000000.0,70517000000.0
20230316,787162950283,34281085965,33852301604.0,428784361.0,56568983753,6701653873,560917271,545788978.0,15128293.0,843731934036,730593966530,330501000000.0,122000000.0,63058000000.0
20230317,786383574652,39068034165,39847409796.0,-779375631.0,57345804327,6652153657,576102845,625603061.0,-49500216.0,843729378979,729037770325,349191000000.0,147000000.0,84553000000.0
20230320,787692438328,41814575636,40505711960.0,1308863676.0,57188845639,6614620910,572666105,610198852.0,-37532747.0,844881283967,730503592689,392183000000.0,161000000.0,89365000000.0
20230321,788520782368,32669309838,31840965798.0,828344040.0,57318367220,6551344201,537181647,600458356.0,-63276709.0,845839149588,731202415148,322149000000.0,102000000.0,68673000000.0
20230322,789655461766,33975138391,32840458993.0,1134679398.0,57770405696,6578226708,566705818,539823311.0,26882507.0,847425867462,731885056070,307061000000.0,141000000.0,76422000000.0
20230323,791799900643,40663545338,38519106461.0,2144438877.0,59259651500,6631184198,645260577,592303087.0,52957490.0,851059552143,732540249143,334405000000.0,124000000.0,93807000000.0
20230324,792841223125,40411479676,39370157194.0,1041322482.0,58733357057,6512687872,556275072,674771398.0,-118496326.0,851574580182,734107866068,339728000000.0,126000000.0,92017000000.0
20230327,796768269592,43139342595,39212296128.0,3927046467.0,58966395162,6526652915,618706964,604741921.0,13965043.0,855734664754,737801874430,360533000000.0,156000000.0,95841000000.0
20230328,797252237740,35127786654,34643818506.0,483968148.0,58777799031,6539413217,588539553,575779251.0,12760302.0,856030036771,738474438709,317607000000.0,136000000.0,80381000000.0
20230329,796888526748,36917444239,37281155231.0,-363710992.0,59231954420,6492010880,575699974,623102311.0,-47402337.0,856120481168,737656572328,318783000000.0,167000000.0,87855000000.0
20230330,797243830185,37602878950,37247575513.0,355303437.0,58173621523,6375504922,553843872,670349830.0,-116505958.0,855417451708,739070208662,323364000000.0,395000000.0,78983000000.0
20230331,795034645806,34106238293,36315422672.0,-2209184379.0,57857790616,6306690389,532623743,601438276.0,-68814533.0,852892436422,737176855190,316952000000.0,207000000.0,80428000000.0
20230403,798616296684,49362946517,45781295639.0,3581650878.0,59167685939,6320393519,587049485,573346355.0,13703130.0,857783982623,739448610745,400768000000.0,187000000.0,113575000000.0
20230404,798904170550,51543030759,51255156893.0,287873866.0,59246036017,6376485599,631367040,575274960.0,56092080.0,858150206567,739658134533,422150000000.0,105000000.0,134179000000.0
20230406,803674047378,51649107415,46879230587.0,4769876828.0,60117233471,6441987277,560812904,495311226.0,65501678.0,863791280849,743556813907,369507000000.0,144000000.0,138129000000.0
20230407,802280042944,42883030721,44277035155.0,-1394004434.0,60811666711,6372231997,525022348,594777628.0,-69755280.0,863091709655,741468376233,324093000000.0,184000000.0,113113000000.0
20230410,801981114346,48299240663,48598169261.0,-298928598.0,60038159884,6388492565,597722416,581461848.0,16260568.0,862019274230,741942954462,384560000000.0,144000000.0,133067000000.0
20230411,801692525018,39861394451,40149983779.0,-288589328.0,60045128240,6311194939,636039742,713337368.0,-77297626.0,861737653258,741647396778,357720000000.0,110000000.0,110175000000.0
20230412,804889674276,46060362771,42863213513.0,3197149258.0,60951032566,6405359025,631620656,537456570.0,94164086.0,865840706842,743938641710,375386000000.0,150000000.0,107892000000.0
20230413,803802923593,42232410183,43319160866.0,-1086750683.0,60479722651,6424120762,623867131,605105394.0,18761737.0,864282646244,743323200942,374676000000.0,181000000.0,105109000000.0
2023-04-14,802768804602.0,43041935099.0,44076054090.0,-1034118991.0,61974404427.0,6404991109.0,597005094.0,616134747.0,-19129653.0,864743209029.0,740794400175.0,362409000000.0,126000000.0,116965000000.0
2023-04-17,804682524065.0,46609728811.0,44696009348.0,1913719463.0,62688374810.0,6523128219.0,685972707.0,567835597.0,118137110.0,867370898875.0,741994149255.0,418285000000.0,158000000.0,106474000000.0
2023-04-18,804908546312.0,42381170767.0,42155148520.0,226022247.0,62847354366.0,6619408306.0,673123706.0,576843619.0,96280087.0,867755900678.0,742061191946.0,378654000000.0,109000000.0,96588000000.0
2023-04-19,805311386298.0,44363451113.0,43960611127.0,402839986.0,63492538974.0,6653688732.0,639965435.0,605685009.0,34280426.0,868803925272.0,741818847324.0,373593000000.0,97000000.0,104549000000.0
2023-04-20,807839232663.0,46624192858.0,44096346493.0,2527846365.0,64777027195.0,6618087392.0,617181291.0,652782631.0,-35601340.0,872616259858.0,743062205468.0,374683000000.0,104000000.0,127885000000.0
2023-04-21,804442630750.0,45923860618.0,49320462531.0,-3396601913.0,62362398763.0,6604522077.0,658973627.0,672538942.0,-13565315.0,866805029513.0,742080231987.0,407463000000.0,149000000.0,124482000000.0
2023-04-24,805078300023.0,37498242845.0,36862573572.0,635669273.0,61044949011.0,6559367383.0,593894642.0,639049336.0,-45154694.0,866123249034.0,744033351012.0,372727000000.0,120000000.0,101731000000.0
2023-04-25,801483664728.0,38934629730.0,42529265025.0,-3594635295.0,59699301593.0,6451599086.0,660357332.0,768125629.0,-107768297.0,861182966321.0,741784363135.0,393431000000.0,121000000.0,102340000000.0
2023-04-26,798837650589.0,38340974485.0,40986988624.0,-2646014139.0,59326186421.0,6462714487.0,653063191.0,641947790.0,11115401.0,858163837010.0,739511464168.0,380056000000.0,127000000.0,101923000000.0
2023-04-27,796676029935.0,37212492014.0,39374112668.0,-2161620654.0,60041536638.0,6466951539.0,625056460.0,620819408.0,4237052.0,856717566573.0,736634493297.0,377384000000.0,90000000.0,89981000000.0
2023-04-28,791218147988.0,40755540950.0,46213422897.0,-5457881947.0,60737828997.0,6443717077.0,637608900.0,660843362.0,-23234462.0,851955976985.0,730480318991.0,420077000000.0,203000000.0,95610000000.0
2023-05-04,795839338310.0,45694907696.0,41073717374.0,4621190322.0,60838163313.0,6594431587.0,631752554.0,481038044.0,150714510.0,856677501623.0,735001174997.0,466273000000.0,217000000.0,84600000000.0
2023-05-05,793879016645.0,40232453981.0,42192775646.0,-1960321665.0,60387059542.0,6576217765.0,595780484.0,613994306.0,-18213822.0,854266076187.0,733491957103.0,420164000000.0,141000000.0,79459000000.0
2023-05-08,798372769570.0,48370404576.0,43876651651.0,4493752925.0,61872780224.0,6727009409.0,750396191.0,599604547.0,150791644.0,860245549794.0,736499989346.0,493476000000.0,141000000.0,72128000000.0
2023-05-09,800169991423.0,55860294017.0,54063072164.0,1797221853.0,61964448683.0,6851113100.0,772312655.0,648208964.0,124103691.0,862134440106.0,738205542740.0,541684000000.0,118000000.0,78288000000.0
2023-05-10,801598265500.0,40209797332.0,38781523255.0,1428274077.0,61915233321.0,6823253684.0,692326610.0,720186026.0,-27859416.0,863513498821.0,739683032179.0,419133000000.0,117000000.0,71662000000.0
2023-05-11,801209857357.0,32184905589.0,32573313732.0,-388408143.0,61877251778.0,6796949139.0,593832834.0,620137379.0,-26304545.0,863087109135.0,739332605579.0,340429000000.0,148000000.0,61609000000.0
2023-05-12,798267472951.0,29534685922.0,32477070328.0,-2942384406.0,61282813098.0,6777541652.0,615977834.0,635385321.0,-19407487.0,859550286049.0,736984659853.0,328649000000.0,102000000.0,59794000000.0
2023-05-15,799775256756.0,35632057054.0,34124273249.0,1507783805.0,62185354765.0,6770114736.0,649560080.0,656986996.0,-7426916.0,861960611521.0,737589901991.0,368131000000.0,135000000.0,64416000000.0
2023-05-16,798441709558.0,29918961732.0,31252508930.0,-1333547198.0,62462633003.0,6811596862.0,631599355.0,590117229.0,41482126.0,860904342561.0,735979076555.0,321675000000.0,89000000.0,64979000000.0
2023-05-17,799104757554.0,27656510917.0,26993462921.0,663047996.0,61965826648.0,6709915512.0,578935447.0,680616797.0,-101681350.0,861070584202.0,737138930906.0,280233000000.0,90000000.0,62199000000.0
2023-05-18,800333234607.0,31303458484.0,30074981431.0,1228477053.0,62162336558.0,6781272394.0,655316528.0,583959646.0,71356882.0,862495571165.0,738170898049.0,297308000000.0,85000000.0,72050000000.0
2023-05-19,798990859126.0,30208952640.0,31551328121.0,-1342375481.0,62054337253.0,6672384075.0,618034297.0,726922616.0,-108888319.0,861045196379.0,736936521873.0,281357000000.0,94000000.0,79545000000.0
